Player,Pos,Age,Tm,G,GS,MP,FG,FGA,FG%,3P,3PA,3P%,2P,2PA,2P%,eFG%,FT,FTA,FT%,ORB,DRB,TRB,AST,STL,BLK,TOV,PF,PTS
Alex Abrines,SG,24,OKC,72,8,1077,110,277,.397,81,209,.388,29,68,.426,.543,35,41,.854,24,84,108,27,36,8,25,118,336
Quincy Acy,PF,27,BRK,65,8,1248,114,332,.343,89,264,.337,25,68,.368,.477,48,58,.828,38,202,240,52,29,25,58,138,365
Steven Adams,C,24,OKC,72,72,2357,428,681,.628,0,2,.000,428,679,.630,.628,150,267,.562,370,284,654,82,89,77,119,205,1006
Bam Adebayo,C,20,MIA,65,19,1304,166,323,.514,0,7,.000,166,316,.525,.514,121,171,.708,112,247,359,98,29,39,61,134,453
Arron Afflalo,SG,32,ORL,51,3,657,60,153,.392,25,65,.385,35,88,.398,.474,22,26,.846,4,62,66,29,4,9,21,54,167
Cole Aldrich,C,29,MIN,19,0,46,5,15,.333,0,0,,5,15,.333,.333,2,6,.333,3,10,13,2,2,1,1,11,12
LaMarcus Aldridge,C,32,SAS,70,70,2335,638,1253,.509,27,87,.310,611,1166,.524,.520,315,378,.833,230,360,590,144,35,84,107,154,1618
Jarrett Allen,C,19,BRK,67,26,1322,219,374,.586,4,14,.286,215,360,.597,.591,109,139,.784,139,220,359,47,27,72,77,137,551
Kadeem Allen,PG,25,BOS,12,0,39,1,6,.167,0,3,.000,1,3,.333,.167,3,4,.750,1,3,4,3,1,0,4,5,5
Tony Allen,SF,36,NOP,22,0,273,44,91,.484,4,12,.333,40,79,.506,.505,11,21,.524,20,27,47,9,11,3,19,49,103
Al-Farouq Aminu,PF,27,POR,64,62,1918,218,542,.402,120,315,.381,98,227,.432,.513,59,80,.738,90,396,486,78,72,36,71,123,615
Justin Anderson,SF,24,PHI,34,0,467,74,177,.418,28,88,.318,46,89,.517,.497,23,32,.719,21,59,80,23,13,5,14,52,199
Kyle Anderson,SF,24,SAS,69,63,1844,215,408,.527,16,51,.314,199,357,.557,.547,98,137,.715,79,297,376,192,106,53,92,104,544
Ryan Anderson,PF,29,HOU,65,50,1720,207,479,.432,131,338,.388,76,141,.539,.569,72,93,.774,94,235,329,60,24,21,42,124,617
Ike Anigbogu,C,19,IND,10,0,28,4,9,.444,0,0,,4,9,.444,.444,5,6,.833,5,4,9,0,1,3,2,1,13
Giannis Antetokounmpo,PF,23,MIL,72,72,2662,719,1345,.535,43,133,.323,676,1212,.558,.551,475,628,.756,154,568,722,345,104,103,212,224,1956
Carmelo Anthony,PF,33,OKC,74,74,2377,453,1117,.406,164,449,.365,289,668,.433,.479,136,180,.756,61,370,431,96,46,47,96,188,1206
OG Anunoby,SF,20,TOR,68,56,1357,146,316,.462,64,178,.360,82,138,.594,.563,36,57,.632,38,121,159,54,50,11,42,118,392
Ryan Arcidiacono,PG,23,CHI,19,0,185,10,23,.435,6,19,.316,4,4,1.000,.565,4,4,1.000,0,10,10,20,9,0,5,10,30
Trevor Ariza,SF,32,HOU,64,64,2179,258,623,.414,167,444,.376,91,179,.508,.548,76,89,.854,33,253,286,103,94,13,50,125,759
Darrell Arthur,PF,29,DEN,19,1,141,22,47,.468,8,23,.348,14,24,.583,.553,2,3,.667,3,12,15,9,8,3,15,22,54
Jamel Artis,SG,25,ORL,9,0,114,8,27,.296,2,10,.200,6,17,.353,.333,3,5,.600,2,14,16,11,0,1,1,5,21
Omer Asik,C,31,NOP,14,0,121,7,16,.438,0,0,,7,16,.438,.438,4,12,.333,7,30,37,2,1,2,5,14,18
D.J. Augustin,PG,30,ORL,69,30,1640,223,497,.449,106,255,.416,117,242,.483,.555,155,179,.866,28,124,152,266,51,0,110,91,707
Luke Babbitt,SF,28,TOT,48,13,683,90,205,.439,59,146,.404,31,59,.525,.583,17,22,.773,6,86,92,29,8,7,19,54,256
Luke Babbitt,SF,28,ATL,37,9,570,80,168,.476,49,111,.441,31,57,.544,.622,17,22,.773,5,76,81,26,7,5,15,47,226
Luke Babbitt,SF,28,MIA,11,4,113,10,37,.270,10,35,.286,0,2,.000,.405,0,0,,1,10,11,3,1,2,4,7,30
Dwayne Bacon,SG,22,CHO,53,6,713,72,192,.375,11,43,.256,61,149,.409,.404,20,25,.800,4,120,124,38,16,2,23,46,175
Ron Baker,SG,24,NYK,29,1,385,20,59,.339,11,33,.333,9,26,.346,.432,20,26,.769,5,25,30,47,26,6,18,33,71
Wade Baldwin,PG,21,POR,4,0,29,5,7,.714,1,1,1.000,4,6,.667,.786,5,9,.556,0,5,5,2,0,0,2,4,16
Lonzo Ball,PG,20,LAL,52,50,1780,203,564,.360,90,295,.305,113,269,.420,.440,32,71,.451,69,291,360,376,88,43,136,117,528
J.J. Barea,PG,33,DAL,67,8,1573,295,676,.436,112,308,.364,183,368,.497,.519,80,102,.784,14,183,197,425,34,3,140,82,782
Harrison Barnes,PF,25,DAL,74,74,2527,517,1155,.448,114,313,.364,403,842,.479,.497,251,302,.831,75,383,458,150,49,14,113,92,1399
Will Barton,SG,27,DEN,76,35,2493,421,944,.446,142,388,.366,279,556,.502,.521,167,207,.807,64,312,376,309,78,49,140,151,1151
Nicolas Batum,SG,29,CHO,60,60,1890,256,619,.414,86,259,.332,170,360,.472,.483,100,121,.826,53,237,290,329,64,22,120,70,698
Jerryd Bayless,SG,29,PHI,39,11,925,109,262,.416,54,146,.370,55,116,.474,.519,35,44,.795,15,65,80,54,23,6,46,91,307
Aron Baynes,C,31,BOS,75,61,1365,187,394,.475,2,14,.143,185,380,.487,.477,57,76,.750,112,284,396,84,18,47,74,189,433
Kent Bazemore,SG,28,ATL,65,65,1789,284,676,.420,108,274,.394,176,402,.438,.500,160,201,.796,25,223,248,228,100,45,157,147,836
Bradley Beal,SG,24,WAS,77,77,2791,644,1399,.460,187,500,.374,457,899,.508,.527,272,343,.793,57,281,338,351,94,34,204,146,1747
Malik Beasley,SG,21,DEN,61,0,581,72,177,.407,27,81,.333,45,96,.469,.483,22,33,.667,14,57,71,31,15,7,24,36,193
Michael Beasley,PF,29,NYK,70,26,1582,391,769,.508,32,78,.410,359,691,.520,.529,117,150,.780,90,307,397,116,32,40,137,141,931
Marco Belinelli,SG,31,TOT,74,1,1780,300,684,.439,130,348,.374,170,336,.506,.534,134,146,.918,18,113,131,136,59,9,81,80,864
Marco Belinelli,SG,31,ATL,52,1,1210,199,484,.411,92,247,.372,107,237,.451,.506,101,109,.927,13,86,99,103,46,3,54,41,591
Marco Belinelli,SG,31,PHI,22,0,570,101,200,.505,38,101,.376,63,99,.636,.600,33,37,.892,5,27,32,33,13,6,27,39,273
Jordan Bell,C,23,GSW,52,13,755,110,173,.636,0,3,.000,110,170,.647,.636,29,42,.690,57,138,195,97,34,54,46,89,249
DeAndre' Bembry,SF,23,ATL,22,0,378,42,104,.404,8,25,.320,34,79,.430,.442,15,25,.600,8,51,59,34,13,10,39,35,107
Dragan Bender,PF,20,PHO,78,33,1936,168,448,.375,108,298,.362,60,150,.400,.496,36,46,.783,35,284,319,125,22,48,107,157,480
Davis Bertans,PF,25,SAS,73,10,1063,156,358,.436,92,247,.372,64,111,.577,.564,40,49,.816,18,133,151,72,26,28,35,90,444
Patrick Beverley,SG,29,LAC,11,11,334,48,119,.403,24,60,.400,24,59,.407,.504,14,17,.824,16,29,45,32,18,5,25,34,134
Khem Birch,C,25,ORL,36,0,434,45,90,.500,0,0,,45,90,.500,.500,20,32,.625,54,74,128,23,11,13,19,47,110
Jabari Bird,SG,23,BOS,8,0,35,1,4,.250,0,2,.000,1,2,.500,.250,3,6,.500,2,2,4,1,1,0,1,2,5
Bismack Biyombo,C,25,ORL,76,23,1399,163,318,.513,0,1,.000,163,317,.514,.513,94,143,.657,132,300,432,58,18,89,79,145,420
Nemanja Bjelica,PF,29,MIN,63,20,1286,165,347,.476,73,170,.429,92,177,.520,.581,36,45,.800,47,210,257,80,44,14,50,133,439
Tarik Black,C,26,HOU,47,1,470,69,115,.600,0,9,.000,69,106,.651,.600,26,55,.473,59,83,142,12,20,26,32,98,164
Antonio Blakeney,SG,21,CHI,19,0,314,53,143,.371,15,52,.288,38,91,.418,.423,30,39,.769,4,29,33,20,7,1,11,19,151
Eric Bledsoe,PG,28,TOT,69,69,2172,438,939,.466,118,344,.343,320,595,.538,.529,235,300,.783,48,216,264,336,140,40,204,173,1229
Eric Bledsoe,PG,28,PHO,3,3,83,16,40,.400,4,13,.308,12,27,.444,.450,11,14,.786,3,4,7,9,4,2,10,6,47
Eric Bledsoe,PG,28,MIL,66,66,2089,422,899,.469,114,331,.344,308,568,.542,.533,224,286,.783,45,212,257,327,136,38,194,167,1182
Vander Blue,SG,25,LAL,5,0,45,1,5,.200,0,2,.000,1,3,.333,.200,1,2,.500,0,1,1,3,1,0,3,2,3
Bogdan Bogdanovic,SG,25,SAC,74,49,2052,326,720,.453,123,307,.401,203,413,.492,.538,98,116,.845,28,184,212,243,69,16,117,161,873
Bojan Bogdanovic,SF,28,IND,76,76,2354,383,808,.474,145,367,.395,238,441,.540,.564,173,200,.865,29,229,258,115,54,6,102,120,1084
Andrew Bogut,C,33,LAL,23,5,216,17,25,.680,0,0,,17,25,.680,.680,2,2,1.000,26,52,78,15,4,13,19,40,36
Joel Bolomboy,PF,24,MIL,6,0,38,3,6,.500,0,1,.000,3,5,.600,.500,3,6,.500,6,4,10,0,2,0,2,3,9
Devin Booker,SG,21,PHO,54,54,1865,455,1054,.432,147,384,.383,308,670,.460,.501,289,329,.878,26,218,244,253,47,14,194,168,1346
Trevor Booker,PF,30,TOT,63,5,1069,162,312,.519,8,28,.286,154,284,.542,.532,59,85,.694,105,187,292,76,26,20,58,111,391
Trevor Booker,PF,30,BRK,18,5,395,77,150,.513,3,12,.250,74,138,.536,.523,24,43,.558,38,81,119,38,8,5,30,43,181
Trevor Booker,PF,30,PHI,33,0,494,61,109,.560,2,7,.286,59,102,.578,.569,32,39,.821,47,75,122,27,16,11,20,51,156
Trevor Booker,PF,30,IND,12,0,180,24,53,.453,3,9,.333,21,44,.477,.481,3,3,1.000,20,31,51,11,2,4,8,17,54
Chris Boucher,PF,25,GSW,1,0,1,0,1,.000,0,1,.000,0,0,,.000,0,0,,0,1,1,0,0,0,0,0,0
Avery Bradley,SG,27,TOT,46,46,1433,259,625,.414,75,203,.369,184,422,.436,.474,63,82,.768,22,94,116,94,51,8,101,92,656
Avery Bradley,SG,27,DET,40,40,1268,233,570,.409,74,194,.381,159,376,.423,.474,61,80,.763,19,75,94,83,46,7,93,80,601
Avery Bradley,SG,27,LAC,6,6,165,26,55,.473,1,9,.111,25,46,.543,.482,2,2,1.000,3,19,22,11,5,1,8,12,55
Tony Bradley,C,20,UTA,9,0,29,3,11,.273,0,1,.000,3,10,.300,.273,2,2,1.000,4,7,11,1,0,0,0,1,8
Corey Brewer,SF,31,TOT,68,14,1096,127,280,.454,26,92,.283,101,188,.537,.500,61,84,.726,37,102,139,61,68,14,48,128,341
Corey Brewer,SF,31,LAL,54,2,694,78,172,.453,8,43,.186,70,129,.543,.477,34,51,.667,23,70,93,41,41,8,38,83,198
Corey Brewer,SF,31,OKC,14,12,402,49,108,.454,18,49,.367,31,59,.525,.537,27,33,.818,14,32,46,20,27,6,10,45,143
Malcolm Brogdon,PG,25,MIL,46,20,1404,238,489,.487,59,156,.378,179,333,.538,.547,75,85,.882,23,129,152,149,41,13,65,128,610
Aaron Brooks,PG,33,MIN,31,1,188,28,69,.406,11,31,.355,17,38,.447,.486,8,11,.727,7,10,17,20,6,0,10,28,75
Dillon Brooks,SF,22,MEM,77,69,2204,308,704,.438,87,241,.361,221,463,.477,.499,98,133,.737,46,189,235,114,65,16,113,227,801
MarShon Brooks,SG,29,MEM,2,0,40,15,25,.600,6,7,.857,9,18,.500,.720,9,9,1.000,2,0,2,4,3,1,2,1,45
Anthony Brown,SF,25,MIN,1,0,4,1,1,1.000,1,1,1.000,0,0,,1.500,0,0,,0,0,0,1,0,0,0,0,3
Bobby Brown,PG,33,HOU,20,0,115,19,58,.328,11,40,.275,8,18,.444,.422,1,2,.500,0,7,7,11,4,0,9,6,50
Jaylen Brown,SF,21,BOS,65,65,1998,336,732,.459,106,279,.380,230,453,.508,.531,135,209,.646,65,268,333,106,64,24,111,173,913
Lorenzo Brown,PG,27,TOR,13,0,114,9,25,.360,1,8,.125,8,17,.471,.380,2,2,1.000,0,10,10,12,4,0,2,5,21
Markel Brown,SG,26,HOU,4,0,31,2,7,.286,1,5,.200,1,2,.500,.357,0,0,,1,4,5,2,0,0,2,6,5
Sterling Brown,SG,22,MIL,50,4,713,78,189,.413,30,83,.361,48,106,.453,.492,21,24,.875,25,107,132,22,31,11,23,71,207
Nicolas Brussino,SF,24,ATL,4,0,10,0,2,.000,0,2,.000,0,0,,.000,0,0,,0,3,3,0,0,0,0,0,0
Thomas Bryant,C,20,LAL,11,0,34,3,9,.333,1,5,.200,2,4,.500,.389,4,6,.667,1,5,6,2,0,0,1,2,11
Reggie Bullock,SF,26,DET,61,51,1701,262,536,.489,121,274,.442,141,262,.538,.602,38,48,.792,26,125,151,94,47,13,46,68,683
Trey Burke,PG,25,NYK,31,4,616,165,319,.517,32,83,.386,133,236,.564,.567,28,44,.636,12,46,58,137,19,4,34,36,390
Alec Burks,SG,26,UTA,62,1,1030,164,400,.410,43,134,.321,121,266,.455,.464,107,124,.863,18,168,186,64,37,8,58,72,478
Jimmy Butler,SG,28,MIN,56,56,2077,417,882,.473,69,194,.356,348,688,.506,.512,340,393,.865,75,230,305,279,108,23,103,74,1243
Dwight Buycks,PG,28,DET,29,0,427,82,198,.414,15,45,.333,67,153,.438,.452,36,41,.878,12,29,41,59,19,2,39,39,215
Bruno Caboclo,SF,22,TOT,10,0,94,9,30,.300,3,17,.176,6,13,.462,.350,5,6,.833,7,12,19,5,3,4,4,8,26
Bruno Caboclo,SF,22,TOR,2,0,7,0,2,.000,0,2,.000,0,0,,.000,0,0,,0,1,1,1,1,0,0,1,0
Bruno Caboclo,SF,22,SAC,8,0,87,9,28,.321,3,15,.200,6,13,.462,.375,5,6,.833,7,11,18,4,2,4,4,7,26
Jose Calderon,PG,36,CLE,54,31,862,85,169,.503,41,88,.466,44,81,.543,.624,22,28,.786,12,64,76,112,25,1,40,78,233
Kentavious Caldwell-Pope,SG,24,LAL,68,68,2299,318,746,.426,149,391,.381,169,355,.476,.526,139,179,.777,58,311,369,148,102,13,92,132,924
Isaiah Canaan,PG-SG,26,TOT,20,1,422,52,137,.380,22,66,.333,30,71,.423,.460,46,51,.902,6,39,45,76,16,1,29,36,172
Isaiah Canaan,SG,26,HOU,1,0,4,0,1,.000,0,0,,0,1,.000,.000,0,0,,0,1,1,0,0,0,0,0,0
Isaiah Canaan,PG,26,PHO,19,1,418,52,136,.382,22,66,.333,30,70,.429,.463,46,51,.902,6,38,44,76,16,1,29,36,172
Clint Capela,C,23,HOU,70,70,1929,418,645,.648,0,1,.000,418,644,.649,.648,138,245,.563,231,532,763,67,53,132,100,180,974
DeMarre Carroll,SF,31,BRK,72,72,2161,322,778,.414,142,386,.368,180,392,.459,.505,187,244,.766,105,372,477,147,59,30,100,164,973
Vince Carter,SF,41,SAC,54,4,950,106,265,.400,53,154,.344,53,111,.477,.500,23,32,.719,16,118,134,62,41,26,33,90,288
Michael Carter-Williams,PG,26,CHO,52,2,835,76,229,.332,14,59,.237,62,170,.365,.362,73,89,.820,37,101,138,116,44,23,52,99,239
Alex Caruso,PG,23,LAL,31,1,442,36,85,.424,7,30,.233,29,55,.527,.465,15,22,.682,10,36,46,59,18,10,32,40,94
Omri Casspi,SF,29,GSW,53,7,740,120,207,.580,10,22,.455,110,185,.595,.604,50,69,.725,30,170,200,51,18,19,37,70,300
Willie Cauley-Stein,C,24,SAC,69,54,1906,352,709,.496,3,12,.250,349,697,.501,.499,142,227,.626,125,348,473,160,73,62,105,174,849
Tyler Cavanaugh,PF,23,ATL,38,1,509,65,145,.448,31,86,.360,34,59,.576,.555,17,21,.810,43,80,123,27,9,4,14,61,178
Mario Chalmers,PG,31,MEM,62,10,1353,159,420,.379,50,178,.281,109,242,.450,.438,107,125,.856,13,137,150,188,74,11,110,171,475
Tyson Chandler,C,35,PHO,46,46,1151,121,187,.647,0,0,,121,187,.647,.647,58,94,.617,134,284,418,53,16,27,59,106,300
Wilson Chandler,SF,30,DEN,69,66,2169,265,593,.447,82,229,.358,183,364,.503,.516,85,110,.773,97,268,365,153,41,37,89,147,697
Marquese Chriss,PF,20,PHO,70,47,1473,193,457,.422,55,185,.297,138,272,.507,.482,86,146,.589,73,301,374,81,50,69,103,199,527
Ian Clark,SG,26,NOP,71,2,1387,210,472,.445,57,185,.308,153,287,.533,.505,45,59,.763,10,110,120,102,28,10,57,117,522
Jordan Clarkson,SG,25,TOT,76,2,1801,414,910,.455,108,308,.351,306,602,.508,.514,148,186,.796,55,157,212,214,55,5,122,102,1084
Jordan Clarkson,SG,25,LAL,53,2,1256,299,667,.448,68,210,.324,231,457,.505,.499,105,132,.795,44,115,159,173,39,3,95,63,771
Jordan Clarkson,SG,25,CLE,23,0,545,115,243,.473,40,98,.408,75,145,.517,.556,43,54,.796,11,42,53,41,16,2,27,39,313
Gian Clavell,SG,24,DAL,7,0,64,6,18,.333,6,15,.400,0,3,.000,.500,2,2,1.000,1,6,7,3,2,0,2,8,20
Antonius Cleveland,SG,23,DAL,13,0,81,4,14,.286,0,1,.000,4,13,.308,.286,2,4,.500,2,8,10,2,6,4,2,11,10
John Collins,PF,20,ATL,69,21,1630,289,494,.585,11,34,.324,278,460,.604,.596,125,169,.740,167,332,499,80,42,76,94,202,714
Zach Collins,C,20,POR,61,1,956,108,266,.406,34,102,.333,74,164,.451,.470,26,40,.650,42,160,202,49,16,30,54,124,276
Kyle Collinsworth,SF,26,DAL,27,1,371,26,68,.382,4,13,.308,22,55,.400,.412,16,32,.500,25,58,83,38,15,6,18,35,72
Darren Collison,PG,30,IND,64,59,1901,294,595,.494,87,193,.451,207,402,.515,.567,125,142,.880,35,131,166,345,88,15,82,115,800
Nick Collison,PF,37,OKC,13,0,72,13,19,.684,0,0,,13,19,.684,.684,4,8,.500,6,13,19,4,0,0,7,7,30
Mike Conley,PG,30,MEM,12,12,373,64,168,.381,24,77,.312,40,91,.440,.452,53,66,.803,0,27,27,49,12,3,18,24,205
Pat Connaughton,SG,25,POR,77,5,1413,156,376,.415,71,203,.350,85,173,.491,.509,36,43,.837,32,118,150,89,21,22,41,114,419
Quinn Cook,PG,24,GSW,28,13,559,97,199,.487,34,80,.425,63,119,.529,.573,17,19,.895,6,57,63,66,11,1,26,44,245
Charles Cooke,SG,23,NOP,11,0,34,2,12,.167,1,7,.143,1,5,.200,.208,1,2,.500,0,2,2,1,1,0,1,0,6
Jack Cooley,PF,26,SAC,4,0,43,8,15,.533,0,0,,8,15,.533,.533,4,5,.800,9,10,19,4,1,0,0,7,20
Matt Costello,C,24,SAS,4,0,32,2,4,.500,0,0,,2,4,.500,.500,0,0,,1,8,9,2,2,2,1,7,4
DeMarcus Cousins,C,27,NOP,48,48,1737,406,864,.470,104,294,.354,302,570,.530,.530,294,394,.746,105,512,617,257,79,76,242,183,1210
Robert Covington,PF,27,PHI,74,74,2352,324,785,.413,190,514,.370,134,271,.494,.534,110,129,.853,53,345,398,143,121,58,119,224,948
Allen Crabbe,SG,25,BRK,71,64,2085,305,770,.396,178,488,.365,127,282,.450,.512,100,119,.840,26,277,303,105,44,32,75,162,888
Torrey Craig,SF,27,DEN,34,5,568,61,129,.473,17,52,.327,44,77,.571,.539,22,35,.629,37,80,117,22,9,10,16,55,161
Jamal Crawford,SG,37,MIN,76,0,1566,301,715,.421,103,304,.339,198,411,.482,.493,99,110,.900,18,73,91,176,39,8,92,82,804
Jordan Crawford,SG,29,NOP,2,0,37,7,14,.500,4,5,.800,3,9,.333,.643,0,0,,2,1,3,9,0,1,4,6,18
Jae Crowder,SF,27,TOT,75,47,1978,253,618,.409,101,310,.326,152,308,.494,.491,113,138,.819,54,205,259,92,57,18,70,175,720
Jae Crowder,SF,27,CLE,53,47,1346,157,376,.418,62,189,.328,95,187,.508,.500,78,92,.848,41,132,173,58,41,12,42,124,454
Jae Crowder,SF,27,UTA,22,0,632,96,242,.397,39,121,.322,57,121,.471,.477,35,46,.761,13,73,86,34,16,6,28,51,266
Dante Cunningham,SF,30,TOT,69,25,1483,153,337,.454,56,158,.354,97,179,.542,.537,30,51,.588,69,204,273,43,37,26,30,107,392
Dante Cunningham,SF,30,NOP,51,24,1115,99,225,.440,35,108,.324,64,117,.547,.518,20,36,.556,50,143,193,26,27,16,16,75,253
Dante Cunningham,SF,30,BRK,18,1,368,54,112,.482,21,50,.420,33,62,.532,.576,10,15,.667,19,61,80,17,10,10,14,32,139
Stephen Curry,PG,29,GSW,51,51,1631,428,864,.495,212,501,.423,216,363,.595,.618,278,302,.921,36,225,261,310,80,8,153,114,1346
Troy Daniels,SG,26,PHO,77,13,1600,231,569,.406,182,455,.400,49,114,.430,.566,56,64,.875,12,113,125,48,25,5,54,135,700
Anthony Davis,PF,24,NOP,70,70,2551,729,1362,.535,52,154,.338,677,1208,.560,.554,455,545,.835,174,602,776,162,104,174,152,150,1965
Deyonta Davis,C,21,MEM,57,4,819,139,227,.612,0,0,,139,227,.612,.612,37,54,.685,64,151,215,36,12,35,28,116,315
Ed Davis,C,28,POR,76,0,1439,168,287,.585,0,1,.000,168,286,.587,.585,74,111,.667,181,381,562,40,32,51,63,183,410
Dewayne Dedmon,C,28,ATL,58,42,1436,234,446,.525,48,135,.356,186,311,.598,.578,59,75,.787,96,360,456,82,39,46,82,151,575
Sam Dekker,PF,23,LAC,69,1,817,115,239,.481,10,60,.167,105,179,.587,.502,36,53,.679,38,117,155,34,22,9,30,64,276
Malcolm Delaney,PG,28,ATL,54,3,1014,109,285,.382,46,124,.371,63,161,.391,.463,74,92,.804,9,91,100,163,35,6,66,82,338
Matthew Dellavedova,PG,27,MIL,37,3,702,55,149,.369,29,77,.377,26,72,.361,.466,23,25,.920,13,50,63,142,14,0,48,67,162
Luol Deng,SF,32,LAL,1,1,13,1,2,.500,0,0,,1,2,.500,.500,0,0,,0,0,0,1,1,0,1,0,2
DeMar DeRozan,SG,28,TOR,75,75,2556,615,1337,.460,84,270,.311,531,1067,.498,.491,444,539,.824,56,239,295,390,81,19,167,141,1758
Cheick Diallo,PF,21,NOP,47,0,515,92,161,.571,0,0,,92,161,.571,.571,48,61,.787,40,149,189,16,10,19,22,70,232
Gorgui Dieng,C,28,MIN,75,0,1281,175,368,.476,15,54,.278,160,314,.510,.496,76,98,.776,98,243,341,69,44,37,58,138,441
Spencer Dinwiddie,PG,24,BRK,76,57,2184,308,796,.387,131,403,.325,177,393,.450,.469,207,253,.818,40,207,247,496,66,23,117,180,954
Tyler Dorsey,SG,21,ATL,51,5,832,117,321,.364,58,171,.339,59,150,.393,.455,33,48,.688,14,98,112,72,13,4,34,55,325
Damyean Dotson,SG,23,NYK,39,2,344,47,110,.427,14,45,.311,33,65,.508,.491,11,15,.733,7,48,55,22,7,1,13,23,119
Milton Doyle,SG,24,BRK,6,0,63,7,25,.280,2,13,.154,5,12,.417,.320,2,3,.667,2,7,9,4,2,1,2,3,18
PJ Dozier,PG,21,OKC,2,0,3,1,2,.500,0,0,,1,2,.500,.500,0,0,,0,1,1,0,0,0,1,1,2
Goran Dragic,PG,31,MIA,72,72,2295,467,1041,.449,107,292,.366,360,749,.481,.500,214,267,.801,53,239,292,347,59,12,159,174,1255
Larry Drew,PG,27,TOT,9,0,65,7,22,.318,3,8,.375,4,14,.286,.386,0,0,,3,0,3,8,0,0,3,6,17
Larry Drew,PG,27,PHI,3,0,15,1,7,.143,0,3,.000,1,4,.250,.143,0,0,,1,0,1,2,0,0,1,2,2
Larry Drew,PG,27,NOP,6,0,50,6,15,.400,3,5,.600,3,10,.300,.500,0,0,,2,0,2,6,0,0,2,4,15
Andre Drummond,C,24,DET,75,75,2504,446,845,.528,0,8,.000,446,837,.533,.528,235,380,.618,384,814,1198,228,111,124,192,239,1127
Jared Dudley,PF,32,PHO,45,0,626,42,110,.382,28,75,.373,14,35,.400,.509,24,29,.828,8,77,85,74,22,9,26,78,136
Kris Dunn,PG,23,CHI,52,43,1525,286,666,.429,43,134,.321,243,532,.457,.462,84,115,.730,24,197,221,310,104,27,150,175,699
Kevin Durant,PF,29,GSW,63,63,2161,586,1125,.521,163,379,.430,423,746,.567,.593,325,367,.886,31,400,431,340,45,117,192,123,1660
Jarell Eddie,SF,26,TOT,3,0,9,0,2,.000,0,2,.000,0,0,,.000,0,0,,0,1,1,0,1,0,0,0,0
Jarell Eddie,SF,26,BOS,2,0,6,0,1,.000,0,1,.000,0,0,,.000,0,0,,0,1,1,0,1,0,0,0,0
Jarell Eddie,SF,26,CHI,1,0,3,0,1,.000,0,1,.000,0,0,,.000,0,0,,0,0,0,0,0,0,0,0,0
Henry Ellenson,PF,21,DET,33,0,229,35,103,.340,12,40,.300,23,63,.365,.398,13,16,.813,9,50,59,17,3,0,13,13,95
Wayne Ellington,SG,30,MIA,72,2,1916,262,653,.401,210,540,.389,52,113,.460,.562,65,76,.855,21,185,206,77,47,6,52,88,799
Joel Embiid,C,23,PHI,63,63,1912,510,1056,.483,66,214,.308,444,842,.527,.514,359,467,.769,143,547,690,199,40,111,234,209,1445
James Ennis,SF,27,TOT,67,22,1533,173,360,.481,48,141,.340,125,219,.571,.547,95,114,.833,73,146,219,68,45,18,54,128,489
James Ennis,SF,27,MEM,45,14,1053,108,222,.486,30,84,.357,78,138,.565,.554,64,73,.877,53,104,157,49,32,12,38,81,310
James Ennis,SF,27,DET,22,8,480,65,138,.471,18,57,.316,47,81,.580,.536,31,41,.756,20,42,62,19,13,6,16,47,179
Tyler Ennis,PG,23,LAL,48,11,530,67,166,.404,10,43,.233,57,123,.463,.434,14,20,.700,13,58,71,79,20,8,25,61,158
Jawun Evans,PG,21,LAC,48,4,778,89,253,.352,15,54,.278,74,199,.372,.381,38,49,.776,9,75,84,100,36,6,44,97,231
Tyreke Evans,PG,28,MEM,52,32,1607,366,809,.452,114,286,.399,252,523,.482,.523,164,209,.785,44,221,265,269,57,17,117,96,1010
Dante Exum,PG,22,UTA,9,0,133,29,50,.580,4,10,.400,25,40,.625,.620,18,20,.900,2,14,16,25,5,1,11,10,80
Kenneth Faried,PF,28,DEN,32,7,461,76,148,.514,0,1,.000,76,147,.517,.514,36,51,.706,68,85,153,18,12,13,23,51,188
Derrick Favors,C,26,UTA,72,72,2015,365,647,.564,12,53,.226,353,594,.594,.573,135,208,.649,186,327,513,99,52,76,85,153,877
Kay Felder,PG,22,TOT,15,0,137,20,68,.294,4,19,.211,16,49,.327,.324,11,12,.917,2,13,15,20,3,1,16,11,55
Kay Felder,PG,22,CHI,14,0,134,20,66,.303,4,18,.222,16,48,.333,.333,11,12,.917,1,13,14,20,3,1,15,11,55
Kay Felder,PG,22,DET,1,0,3,0,2,.000,0,1,.000,0,1,.000,.000,0,0,,1,0,1,0,0,0,1,0,0
Cristiano Felicio,C,25,CHI,50,11,831,109,183,.596,0,1,.000,109,182,.599,.596,42,65,.646,71,123,194,47,9,11,45,91,260
Raymond Felton,PG,33,OKC,78,2,1312,218,532,.410,76,218,.349,142,314,.452,.481,35,43,.814,25,126,151,200,48,14,71,86,547
Terrance Ferguson,SG,19,OKC,59,12,728,65,159,.409,35,110,.318,30,49,.612,.519,9,10,.900,19,25,44,17,23,10,11,79,174
Yogi Ferrell,SG,24,DAL,77,21,2202,298,699,.426,127,340,.374,171,359,.476,.517,79,99,.798,26,219,245,184,62,8,76,150,802
Dorian Finney-Smith,PF,24,DAL,17,9,309,25,69,.362,12,44,.273,13,25,.520,.449,8,11,.727,13,36,49,15,7,4,15,32,70
Bryn Forbes,SG,24,SAS,75,12,1428,194,466,.416,84,217,.387,110,249,.442,.506,44,68,.647,11,93,104,75,26,2,37,101,516
Evan Fournier,SF,25,ORL,57,57,1837,368,802,.459,127,335,.379,241,467,.516,.538,150,173,.867,23,157,180,165,47,16,95,138,1013
De'Aaron Fox,PG,20,SAC,69,56,1889,308,743,.415,41,138,.297,267,605,.441,.442,128,177,.723,27,150,177,300,67,19,160,155,785
Tim Frazier,PG,27,WAS,55,11,797,64,162,.395,16,55,.291,48,107,.449,.444,23,30,.767,18,89,107,187,42,7,55,91,167
Channing Frye,C,34,TOT,48,1,600,88,179,.492,32,97,.330,56,82,.683,.581,14,15,.933,11,111,122,31,17,13,17,60,222
Channing Frye,C,34,CLE,44,1,545,84,169,.497,30,90,.333,54,79,.684,.586,14,15,.933,10,100,110,28,17,12,17,54,212
Channing Frye,C,34,LAL,4,0,55,4,10,.400,2,7,.286,2,3,.667,.500,0,0,,1,11,12,3,0,1,0,6,10
Markelle Fultz,SG,19,PHI,8,0,139,21,58,.362,0,0,,21,58,.362,.362,9,16,.563,7,13,20,26,6,2,8,12,51
Danilo Gallinari,SF,29,LAC,21,21,671,102,256,.398,36,111,.324,66,145,.455,.469,81,87,.931,9,92,101,41,12,10,26,30,321
Langston Galloway,SG,26,DET,54,2,782,115,304,.378,68,197,.345,47,107,.439,.490,27,34,.794,12,71,83,53,30,5,17,38,325
Marc Gasol,C,33,MEM,71,71,2354,426,1014,.420,106,313,.339,320,701,.456,.472,280,336,.833,75,506,581,293,52,100,188,180,1238
Pau Gasol,C,37,SAS,72,60,1713,275,598,.460,41,112,.366,234,486,.481,.494,150,199,.754,120,467,587,223,22,76,104,109,741
Rudy Gay,PF,31,SAS,52,6,1116,227,483,.470,32,102,.314,195,381,.512,.503,100,129,.775,69,195,264,65,40,35,73,92,586
Paul George,SF,27,OKC,75,75,2742,545,1264,.431,225,565,.398,320,699,.458,.520,308,378,.815,67,359,426,254,156,38,201,222,1623
Marcus Georges-Hunt,SG,23,MIN,41,0,223,20,47,.426,3,14,.214,17,33,.515,.457,13,21,.619,7,9,16,7,6,0,3,32,56
Taj Gibson,PF,32,MIN,78,78,2613,405,697,.581,7,35,.200,398,662,.601,.586,135,176,.767,182,368,550,97,60,54,85,206,952
Manu Ginobili,SG,40,SAS,61,0,1215,187,432,.433,58,177,.328,129,255,.506,.500,100,121,.826,19,111,130,151,41,16,96,116,532
Rudy Gobert,C,25,UTA,51,51,1666,253,405,.625,0,0,,253,405,.625,.625,193,278,.694,149,403,552,68,39,119,94,140,699
Aaron Gordon,PF,22,ORL,53,52,1785,349,799,.437,107,312,.343,242,487,.497,.504,151,214,.706,87,353,440,127,51,42,96,104,956
Eric Gordon,SG,29,HOU,67,30,2101,410,949,.432,214,590,.363,196,359,.546,.545,194,239,.812,23,144,167,149,42,27,127,113,1228
Marcin Gortat,C,33,WAS,77,77,1952,275,529,.520,0,0,,275,529,.520,.520,107,159,.673,169,420,589,145,38,58,93,165,657
Treveon Graham,SG,24,CHO,63,2,1050,96,221,.434,40,97,.412,56,124,.452,.525,41,59,.695,42,79,121,59,33,2,27,109,273
Jerami Grant,PF,23,OKC,77,1,1569,232,439,.528,31,108,.287,201,331,.607,.564,141,215,.656,85,220,305,55,30,69,54,151,636
Jerian Grant,PG,25,CHI,69,26,1549,187,454,.412,56,167,.335,131,287,.456,.474,131,174,.753,31,134,165,325,55,7,82,121,561
Josh Gray,PG,24,PHO,5,0,86,11,41,.268,3,13,.231,8,28,.286,.305,7,11,.636,2,8,10,12,8,2,7,8,32
Danny Green,SG,30,SAS,65,57,1689,209,530,.394,114,307,.371,95,223,.426,.502,44,55,.800,40,196,236,100,58,77,67,112,576
Draymond Green,PF,27,GSW,65,65,2134,267,585,.456,73,238,.307,194,347,.559,.519,123,159,.774,73,436,509,478,90,89,180,175,730
Gerald Green,SG,32,HOU,36,1,802,140,353,.397,92,253,.364,48,100,.480,.527,42,51,.824,14,101,115,21,21,13,21,77,414
JaMychal Green,PF,27,MEM,55,54,1542,223,488,.457,43,127,.339,180,361,.499,.501,80,111,.721,147,317,464,79,32,25,76,153,569
Jeff Green,PF,31,CLE,73,9,1690,268,577,.464,44,153,.288,224,424,.528,.503,188,218,.862,57,178,235,93,38,29,71,137,768
Blake Griffin,PF,28,TOT,58,58,1970,436,996,.438,111,322,.345,325,674,.482,.493,259,330,.785,73,355,428,334,41,18,165,139,1242
Blake Griffin,PF,28,LAC,33,33,1139,255,578,.441,64,187,.342,191,391,.488,.497,172,219,.785,46,216,262,179,30,9,99,78,746
Blake Griffin,PF,28,DET,25,25,831,181,418,.433,47,135,.348,134,283,.473,.489,87,111,.784,27,139,166,155,11,9,66,61,496
Daniel Hamilton,SG,22,OKC,5,0,26,5,11,.455,2,5,.400,3,6,.500,.545,0,0,,0,5,5,7,1,0,2,0,12
Tim Hardaway,SG,25,NYK,55,52,1821,349,833,.419,125,396,.316,224,437,.513,.494,142,173,.821,32,180,212,148,59,10,89,117,965
James Harden,SG,28,HOU,68,68,2415,619,1387,.446,251,693,.362,368,694,.530,.537,593,689,.861,38,327,365,595,122,47,293,163,2082
Maurice Harkless,SF,24,POR,59,36,1264,147,297,.495,49,118,.415,98,179,.547,.577,42,59,.712,46,116,162,53,48,43,40,103,385
Montrezl Harrell,C,24,LAC,71,3,1164,313,489,.640,1,5,.200,312,484,.645,.641,132,204,.647,97,183,280,61,31,47,62,131,759
Devin Harris,PG,34,TOT,66,1,1252,172,419,.411,71,207,.343,101,212,.476,.495,136,162,.840,12,106,118,139,47,12,72,155,551
Devin Harris,PG,34,DAL,44,1,807,118,284,.415,44,125,.352,74,159,.465,.493,93,112,.830,9,76,85,85,33,8,49,103,373
Devin Harris,PG,34,DEN,22,0,445,54,135,.400,27,82,.329,27,53,.509,.500,43,50,.860,3,30,33,54,14,4,23,52,178
Gary Harris,SG,23,DEN,65,65,2265,432,889,.486,155,388,.399,277,501,.553,.573,129,156,.827,37,137,174,193,120,15,118,119,1148
Joe Harris,SG,26,BRK,75,11,1894,288,593,.486,140,341,.411,148,252,.587,.604,84,101,.832,51,201,252,116,34,18,88,148,800
Tobias Harris,PF,25,TOT,75,75,2511,527,1142,.461,177,425,.416,350,717,.488,.539,163,198,.823,56,349,405,177,65,34,94,153,1394
Tobias Harris,PF,25,DET,48,48,1563,320,709,.451,113,276,.409,207,433,.478,.531,115,136,.846,36,208,244,94,34,15,51,91,868
Tobias Harris,PF,25,LAC,27,27,948,207,433,.478,64,149,.430,143,284,.504,.552,48,62,.774,20,141,161,83,31,19,43,62,526
Aaron Harrison,SG,23,DAL,5,1,97,7,27,.259,2,18,.111,5,9,.556,.296,6,7,.857,1,11,12,4,3,2,1,13,22
Andrew Harrison,PG,23,MEM,56,46,1326,181,429,.422,47,142,.331,134,287,.467,.477,124,159,.780,23,108,131,177,38,26,81,138,533
Shaquille Harrison,PG,24,PHO,19,1,268,39,88,.443,5,21,.238,34,67,.507,.472,24,32,.750,7,44,51,33,19,6,14,36,107
Josh Hart,SG,22,LAL,57,20,1243,138,302,.457,62,161,.385,76,141,.539,.560,44,66,.667,37,185,222,69,39,13,36,94,382
Udonis Haslem,C,37,MIA,13,0,66,3,14,.214,1,7,.143,2,7,.286,.250,0,0,,3,6,9,5,0,2,2,2,7
Nigel Hayes,SF,23,TOT,5,0,39,4,12,.333,3,8,.375,1,4,.250,.458,1,3,.333,0,3,3,3,0,1,1,1,12
Nigel Hayes,SF,23,LAL,2,0,11,1,3,.333,0,2,.000,1,1,1.000,.333,1,1,1.000,0,0,0,2,0,0,0,0,3
Nigel Hayes,SF,23,TOR,2,0,6,2,2,1.000,2,2,1.000,0,0,,1.500,0,0,,0,0,0,0,0,0,1,0,6
Nigel Hayes,SF,23,SAC,1,0,22,1,7,.143,1,4,.250,0,3,.000,.214,0,2,.000,0,3,3,1,0,1,0,1,3
Gordon Hayward,SF,27,BOS,1,1,5,1,2,.500,0,1,.000,1,1,1.000,.500,0,0,,0,1,1,0,0,0,0,1,2
Reggie Hearn,SG,26,DET,2,0,3,1,1,1.000,1,1,1.000,0,0,,1.500,0,0,,0,0,0,0,0,0,0,0,3
Myke Henry,SF,25,MEM,15,0,279,30,78,.385,15,43,.349,15,35,.429,.481,6,10,.600,7,18,25,16,21,5,14,21,81
John Henson,C,27,MIL,71,64,1840,266,467,.570,1,7,.143,265,460,.576,.571,88,146,.603,142,341,483,106,39,102,81,191,621
Juan Hernangomez,PF,22,DEN,24,3,275,29,74,.392,14,49,.286,15,25,.600,.486,10,12,.833,18,36,54,12,6,3,9,24,82
Willy Hernangomez,C,23,TOT,44,1,415,76,139,.547,3,10,.300,73,129,.566,.558,49,79,.620,53,91,144,29,15,14,32,56,204
Willy Hernangomez,C,23,NYK,26,0,233,49,81,.605,1,5,.200,48,76,.632,.611,12,28,.429,22,45,67,21,8,7,26,32,111
Willy Hernangomez,C,23,CHO,18,1,182,27,58,.466,2,5,.400,25,53,.472,.483,37,51,.725,31,46,77,8,7,7,6,24,93
Mario Hezonja,SF,22,ORL,69,24,1474,244,549,.444,77,237,.325,167,312,.535,.515,74,91,.813,37,209,246,88,73,26,76,120,639
Isaiah Hicks,PF,23,NYK,13,0,151,18,40,.450,1,7,.143,17,33,.515,.463,5,10,.500,8,20,28,6,2,2,10,30,42
Buddy Hield,SG,24,SAC,76,12,1905,393,881,.446,168,392,.429,225,489,.460,.541,70,78,.897,48,242,290,143,76,21,115,136,1024
Nene Hilario,C,35,HOU,49,4,717,133,228,.583,0,2,.000,133,226,.588,.583,63,96,.656,49,116,165,44,26,14,37,116,329
George Hill,PG,31,TOT,65,58,1783,233,506,.460,84,202,.416,149,304,.490,.543,108,138,.783,42,136,178,182,57,26,86,127,658
George Hill,PG,31,SAC,43,36,1143,153,326,.469,58,128,.453,95,198,.480,.558,77,99,.778,22,95,117,119,39,12,60,75,441
George Hill,PG,31,CLE,22,22,640,80,180,.444,26,74,.351,54,106,.509,.517,31,39,.795,20,41,61,63,18,14,26,52,217
Solomon Hill,SF,26,NOP,7,1,104,10,26,.385,4,14,.286,6,12,.500,.462,2,4,.500,2,12,14,16,3,0,2,9,26
Darrun Hilliard,SG,24,SAS,14,0,95,5,19,.263,0,6,.000,5,13,.385,.263,6,7,.857,0,7,7,11,2,0,4,7,16
Jrue Holiday,SG,27,NOP,76,76,2759,577,1177,.490,113,338,.334,464,839,.553,.538,177,226,.783,57,287,344,446,110,57,201,189,1444
Justin Holiday,SG,28,CHI,68,68,2153,271,728,.372,153,418,.366,118,310,.381,.477,129,156,.827,31,247,278,142,72,31,87,125,824
John Holland,SF,29,CLE,21,0,135,11,39,.282,7,25,.280,4,14,.286,.372,4,6,.667,4,15,19,4,6,2,5,9,33
Rondae Hollis-Jefferson,SF,23,BRK,63,54,1794,332,699,.475,13,52,.250,319,647,.493,.484,238,305,.780,100,331,431,154,58,41,107,138,915
Richaun Holmes,C,24,PHI,42,2,623,106,202,.525,4,31,.129,102,171,.596,.535,32,48,.667,50,135,185,50,15,22,22,83,248
Rodney Hood,SG,25,TOT,57,20,1547,312,730,.427,126,329,.383,186,401,.464,.514,100,116,.862,22,138,160,90,41,12,70,97,850
Rodney Hood,SG,25,UTA,39,12,1084,234,552,.424,102,262,.389,132,290,.455,.516,85,97,.876,14,97,111,65,30,7,63,64,655
Rodney Hood,SG,25,CLE,18,8,463,78,178,.438,24,67,.358,54,111,.486,.506,15,19,.789,8,41,49,25,11,5,7,33,195
Scotty Hopson,SG,28,DAL,1,0,8,0,1,.000,0,0,,0,1,.000,.000,1,2,.500,0,0,0,1,0,0,1,0,1
Al Horford,C,31,BOS,68,68,2151,349,710,.492,93,215,.433,256,495,.517,.557,79,105,.752,93,407,500,327,38,75,129,133,870
Danuel House,SG,24,PHO,19,0,255,33,81,.407,10,38,.263,23,43,.535,.469,19,22,.864,11,40,51,11,6,4,6,16,95
Dwight Howard,C,32,CHO,77,77,2352,484,871,.556,1,7,.143,483,864,.559,.556,315,553,.570,241,708,949,98,47,124,200,242,1284
Josh Huestis,PF,26,OKC,66,10,968,59,179,.330,32,113,.283,27,66,.409,.419,5,18,.278,42,118,160,20,15,43,26,81,155
R.J. Hunter,SG,24,HOU,4,0,15,0,4,.000,0,3,.000,0,1,.000,.000,0,0,,0,1,1,2,1,0,0,2,0
Vince Hunter,PF,23,MEM,4,0,7,3,5,.600,0,0,,3,5,.600,.600,0,0,,2,1,3,0,0,1,1,0,6
Serge Ibaka,PF,28,TOR,71,71,1952,349,729,.479,98,279,.351,251,450,.558,.546,92,113,.814,71,372,443,56,27,91,83,198,888
Andre Iguodala,SF,34,GSW,63,7,1601,146,314,.465,33,113,.292,113,201,.562,.518,55,87,.632,50,193,243,205,54,38,67,96,380
Ersan Ilyasova,PF,30,TOT,63,41,1566,249,545,.457,81,226,.358,168,319,.527,.531,90,115,.783,102,245,347,78,57,23,65,142,669
Ersan Ilyasova,PF,30,ATL,46,40,1175,184,401,.459,61,170,.359,123,231,.532,.535,72,90,.800,74,177,251,51,44,17,43,92,501
Ersan Ilyasova,PF,30,PHI,17,1,391,65,144,.451,20,56,.357,45,88,.511,.521,18,25,.720,28,68,96,27,13,6,22,50,168
Joe Ingles,SF,30,UTA,77,76,2427,314,679,.462,195,442,.441,119,237,.502,.606,62,75,.827,22,306,328,357,84,17,150,168,885
Brandon Ingram,SF,20,LAL,59,59,1975,358,761,.470,41,105,.390,317,656,.483,.497,192,282,.681,57,257,314,230,45,43,149,163,949
Kyrie Irving,PG,25,BOS,60,60,1931,534,1087,.491,166,407,.408,368,680,.541,.568,232,261,.889,33,194,227,306,65,17,140,122,1466
Jonathan Isaac,PF,20,ORL,27,10,536,55,145,.379,16,46,.348,39,99,.394,.434,19,25,.760,16,83,99,18,33,30,27,48,145
Wesley Iwundu,SF,23,ORL,56,6,848,77,178,.433,7,35,.200,70,143,.490,.452,28,36,.778,28,91,119,50,30,10,25,66,189
Jarrett Jack,PG,34,NYK,58,56,1483,178,419,.425,24,81,.296,154,338,.456,.453,58,70,.829,20,159,179,333,35,4,112,95,438
Demetrius Jackson,PG,23,TOT,14,0,78,7,18,.389,1,7,.143,6,11,.545,.417,1,2,.500,5,7,12,8,5,1,11,7,16
Demetrius Jackson,PG,23,HOU,12,0,63,4,14,.286,0,6,.000,4,8,.500,.286,0,0,,4,7,11,5,4,1,10,6,8
Demetrius Jackson,PG,23,PHI,2,0,15,3,4,.750,1,1,1.000,2,3,.667,.875,1,2,.500,1,0,1,3,1,0,1,1,8
Josh Jackson,SF,20,PHO,75,33,1891,372,885,.420,55,211,.261,317,674,.470,.451,163,261,.625,88,246,334,116,76,33,139,212,962
Justin Jackson,SF,22,SAC,64,37,1371,173,388,.446,51,166,.307,122,222,.550,.512,24,34,.706,25,146,171,66,27,11,37,68,421
Reggie Jackson,PG,27,DET,40,40,1063,223,513,.435,48,152,.316,175,361,.485,.481,94,115,.817,27,85,112,202,24,3,94,79,588
LeBron James,PF,33,CLE,77,77,2860,809,1492,.542,137,377,.363,672,1115,.603,.588,356,486,.733,93,575,668,703,112,70,321,129,2111
Mike James,PG,27,TOT,36,10,687,123,321,.383,26,98,.265,97,223,.435,.424,64,84,.762,13,77,90,126,28,7,49,48,336
Mike James,PG,27,PHO,32,10,669,121,312,.388,26,97,.268,95,215,.442,.429,64,84,.762,12,77,89,120,27,7,48,45,332
Mike James,PG,27,NOP,4,0,18,2,9,.222,0,1,.000,2,8,.250,.222,0,0,,1,0,1,6,1,0,1,3,4
Al Jefferson,C,33,IND,34,1,462,104,196,.531,0,1,.000,104,195,.533,.531,26,32,.813,30,104,134,29,16,23,20,63,234
Richard Jefferson,SF,37,DEN,20,0,163,12,27,.444,2,7,.286,10,20,.500,.481,4,7,.571,2,15,17,15,2,1,5,11,30
Brandon Jennings,PG,28,MIL,11,0,156,19,50,.380,8,26,.308,11,24,.458,.460,9,9,1.000,3,18,21,33,5,4,12,9,55
Jonas Jerebko,PF,30,UTA,69,19,1059,146,321,.455,59,145,.407,87,176,.494,.547,44,55,.800,51,184,235,41,23,10,24,118,395
Amir Johnson,C,30,PHI,68,12,1044,119,224,.531,8,28,.286,111,196,.566,.549,47,79,.595,110,182,292,97,42,43,52,176,293
Brice Johnson,PF,23,TOT,18,0,98,20,42,.476,0,1,.000,20,41,.488,.476,3,5,.600,9,22,31,2,9,6,5,13,43
Brice Johnson,PF,23,LAC,9,0,38,7,11,.636,0,1,.000,7,10,.700,.636,2,2,1.000,2,11,13,1,6,2,4,7,16
Brice Johnson,PF,23,MEM,9,0,60,13,31,.419,0,0,,13,31,.419,.419,1,3,.333,7,11,18,1,3,4,1,6,27
Dakari Johnson,C,22,OKC,29,6,159,22,39,.564,0,0,,22,39,.564,.564,11,20,.550,16,18,34,8,6,8,3,27,55
James Johnson,PF,30,MIA,69,37,1843,292,577,.506,56,178,.315,236,399,.591,.555,104,151,.689,58,285,343,266,66,49,133,180,744
Joe Johnson,SF,36,TOT,50,3,1116,137,334,.410,37,133,.278,100,201,.498,.466,37,42,.881,14,146,160,77,18,7,46,60,348
Joe Johnson,SF,36,UTA,32,3,700,95,226,.420,23,84,.274,72,142,.507,.471,20,24,.833,12,95,107,45,12,6,31,32,233
Joe Johnson,SF,36,HOU,18,0,416,42,108,.389,14,49,.286,28,59,.475,.454,17,18,.944,2,51,53,32,6,1,15,28,115
Stanley Johnson,SF,21,DET,64,45,1739,190,508,.374,59,212,.278,131,296,.443,.432,105,133,.789,29,204,233,97,88,13,69,159,544
Tyler Johnson,PG,25,MIA,67,34,1910,288,661,.436,114,308,.370,174,353,.493,.522,103,126,.817,29,197,226,152,55,30,74,140,793
Wesley Johnson,SF,30,LAC,69,37,1421,142,351,.405,59,170,.347,83,181,.459,.489,41,55,.745,27,184,211,56,73,62,54,139,384
Nikola Jokic,C,22,DEN,70,68,2250,459,920,.499,100,255,.392,359,665,.540,.553,248,291,.852,185,557,742,417,80,57,197,196,1266
Damian Jones,C,22,GSW,10,0,40,4,6,.667,0,0,,4,6,.667,.667,2,2,1.000,4,4,8,0,0,1,2,6,10
Derrick Jones,SF,20,TOT,18,8,233,18,47,.383,2,16,.125,16,31,.516,.404,13,20,.650,19,15,34,8,4,13,6,23,51
Derrick Jones,SF,20,PHO,6,0,33,2,4,.500,0,2,.000,2,2,1.000,.500,5,6,.833,2,2,4,3,1,4,1,2,9
Derrick Jones,SF,20,MIA,12,8,200,16,43,.372,2,14,.143,14,29,.483,.395,8,14,.571,17,13,30,5,3,9,5,21,42
Jalen Jones,SF,24,TOT,13,0,107,14,36,.389,5,11,.455,9,25,.360,.458,6,8,.750,8,16,24,2,2,0,3,13,39
Jalen Jones,SF,24,NOP,4,0,19,1,4,.250,1,1,1.000,0,3,.000,.375,2,2,1.000,0,3,3,0,0,0,0,2,5
Jalen Jones,SF,24,DAL,9,0,88,13,32,.406,4,10,.400,9,22,.409,.469,4,6,.667,8,13,21,2,2,0,3,11,34
Tyus Jones,PG,21,MIN,78,11,1404,144,312,.462,40,116,.345,104,196,.531,.526,69,77,.896,16,113,129,219,90,5,56,101,397
DeAndre Jordan,C,29,LAC,72,72,2292,352,545,.646,0,0,,352,545,.646,.646,174,291,.598,307,797,1104,109,38,68,130,192,878
Cory Joseph,PG,26,IND,77,17,2088,242,569,.425,64,179,.358,178,390,.456,.482,69,92,.750,38,216,254,243,76,17,77,134,617
Frank Kaminsky,PF,24,CHO,75,4,1735,286,670,.427,97,254,.382,189,416,.454,.499,148,187,.791,44,228,272,120,36,18,64,87,817
Enes Kanter,C,25,NYK,71,71,1830,422,713,.592,0,2,.000,422,711,.594,.592,156,184,.848,273,507,780,105,36,37,122,187,1000
Luke Kennard,SG,21,DET,68,5,1314,179,412,.434,70,175,.400,109,237,.460,.519,55,63,.873,20,132,152,109,40,13,62,77,483
Michael Kidd-Gilchrist,SF,24,CHO,70,70,1752,271,539,.503,0,2,.000,271,537,.505,.503,110,161,.683,81,210,291,67,49,31,48,137,652
Sean Kilpatrick,SG,28,TOT,47,0,508,77,226,.341,32,115,.278,45,111,.405,.412,49,53,.925,3,72,75,37,9,2,30,27,235
Sean Kilpatrick,SG,28,BRK,16,0,183,25,86,.291,11,42,.262,14,44,.318,.355,18,19,.947,1,34,35,15,2,1,16,8,79
Sean Kilpatrick,SG,28,MIL,23,0,205,31,82,.378,13,46,.283,18,36,.500,.457,18,19,.947,1,24,25,15,5,1,9,15,93
Sean Kilpatrick,SG,28,LAC,4,0,38,7,18,.389,3,7,.429,4,11,.364,.472,2,2,1.000,0,2,2,3,0,0,1,2,19
Sean Kilpatrick,SG,28,CHI,4,0,82,14,40,.350,5,20,.250,9,20,.450,.413,11,13,.846,1,12,13,4,2,0,4,2,44
Maxi Kleber,PF,26,DAL,67,36,1112,131,280,.468,32,113,.283,99,167,.593,.525,43,57,.754,65,139,204,45,26,42,27,108,337
Furkan Korkmaz,SG,20,PHI,11,0,64,6,22,.273,4,14,.286,2,8,.250,.364,2,4,.500,2,7,9,3,1,1,2,7,18
Luke Kornet,PF,22,NYK,15,1,220,29,86,.337,17,59,.288,12,27,.444,.436,3,4,.750,10,36,46,17,5,11,4,13,78
Kyle Korver,SG,36,CLE,69,3,1501,214,467,.458,160,364,.440,54,103,.524,.630,61,69,.884,9,145,154,84,27,26,49,120,649
Kosta Koufos,C,28,SAC,71,13,1391,222,389,.571,0,0,,222,389,.571,.571,33,74,.446,149,323,472,87,47,32,49,146,477
Kyle Kuzma,PF,22,LAL,74,34,2303,447,992,.451,153,419,.365,294,573,.513,.528,137,192,.714,87,382,469,139,47,33,129,153,1184
Mindaugas Kuzminskas,SF,28,NYK,1,0,2,0,2,.000,0,0,,0,2,.000,.000,0,0,,0,0,0,0,0,0,0,0,0
Skal Labissiere,PF,21,SAC,60,28,1240,205,458,.448,18,51,.353,187,407,.459,.467,95,118,.805,99,189,288,72,25,49,73,132,523
Jeremy Lamb,SG,25,CHO,76,18,1881,364,802,.454,90,247,.364,274,555,.494,.510,177,206,.859,48,268,316,178,59,32,88,136,995
Shane Larkin,PG,25,BOS,50,1,686,76,194,.392,29,75,.387,47,119,.395,.466,30,33,.909,12,64,76,76,25,2,29,52,211
Joffrey Lauvergne,C,26,SAS,52,1,523,97,186,.522,0,5,.000,97,181,.536,.522,29,45,.644,62,107,169,38,9,3,33,45,223
Zach LaVine,SG,22,CHI,24,24,656,136,355,.383,42,123,.341,94,232,.405,.442,87,107,.813,9,85,94,72,24,4,43,55,401
Jake Layman,SF,23,POR,33,1,155,12,44,.273,4,19,.211,8,25,.320,.318,2,3,.667,4,10,14,10,6,4,5,13,30
T.J. Leaf,PF,20,IND,50,0,428,57,121,.471,18,39,.462,39,82,.476,.545,8,12,.667,26,51,77,8,5,4,10,43,140
Courtney Lee,SG,32,NYK,72,68,2203,320,714,.448,105,264,.398,215,450,.478,.522,114,124,.919,28,183,211,175,78,15,83,103,859
Damion Lee,SG,25,ATL,10,7,260,36,87,.414,10,37,.270,26,50,.520,.471,16,21,.762,4,37,41,19,13,1,8,12,98
"Walt Lemon, Jr.",PG,25,NOP,5,0,35,7,16,.438,1,1,1.000,6,15,.400,.469,2,3,.667,0,2,2,5,0,1,4,5,17
Alex Len,C,24,PHO,65,11,1292,191,339,.563,0,0,,191,339,.563,.563,149,214,.696,165,319,484,72,27,60,72,148,531
Kawhi Leonard,SF,26,SAS,9,9,210,52,111,.468,11,35,.314,41,76,.539,.518,31,38,.816,6,36,42,21,18,9,16,9,146
Meyers Leonard,C,25,POR,29,2,224,39,66,.591,9,21,.429,30,45,.667,.659,8,10,.800,11,49,60,15,5,0,8,29,95
Jon Leuer,PF,28,DET,8,0,136,15,36,.417,0,3,.000,15,33,.455,.417,13,15,.867,7,25,32,5,1,3,7,16,43
Caris LeVert,SF,23,BRK,67,9,1756,304,696,.437,80,232,.345,224,464,.483,.494,129,179,.721,53,198,251,280,75,21,145,153,817
DeAndre Liggins,SG,29,TOT,54,4,707,40,101,.396,19,52,.365,21,49,.429,.490,2,5,.400,7,68,75,45,37,14,20,79,101
DeAndre Liggins,SG,29,MIL,31,1,480,22,65,.338,11,36,.306,11,29,.379,.423,2,5,.400,5,44,49,27,27,10,13,61,57
DeAndre Liggins,SG,29,NOP,23,3,227,18,36,.500,8,16,.500,10,20,.500,.611,0,0,,2,24,26,18,10,4,7,18,44
Damian Lillard,PG,27,POR,69,69,2522,583,1326,.440,213,587,.363,370,739,.501,.520,460,501,.918,58,254,312,455,73,26,195,112,1839
Jeremy Lin,PG,29,BRK,1,1,25,5,12,.417,1,2,.500,4,10,.400,.458,7,7,1.000,0,0,0,4,0,0,3,3,18
Shaun Livingston,PG,32,GSW,68,7,1081,165,324,.509,0,4,.000,165,320,.516,.509,46,57,.807,32,92,124,132,34,20,56,114,376
Kevon Looney,C,21,GSW,62,3,819,95,167,.569,1,4,.250,94,163,.577,.572,42,76,.553,74,121,195,39,30,50,29,96,233
Brook Lopez,C,29,LAL,68,66,1608,346,738,.469,104,301,.346,242,437,.554,.539,101,147,.687,71,200,271,120,29,95,93,187,897
Robin Lopez,C,29,CHI,64,64,1690,342,645,.530,4,14,.286,338,631,.536,.533,68,90,.756,134,156,290,124,14,53,107,109,756
Kevin Love,C,29,CLE,55,55,1526,311,684,.455,120,299,.401,191,385,.496,.542,218,248,.879,98,413,511,94,39,23,85,113,960
Kyle Lowry,PG,31,TOR,72,72,2326,376,873,.431,223,550,.405,153,323,.474,.558,215,251,.857,64,338,402,495,80,15,165,176,1190
Timothe Luwawu-Cabarrot,SF,22,PHI,52,7,807,100,267,.375,53,158,.335,47,109,.431,.474,46,58,.793,14,58,72,54,12,5,38,97,299
Tyler Lydon,PF,21,DEN,1,0,2,0,0,,0,0,,0,0,,,0,0,,0,0,0,0,0,0,0,0,0
Trey Lyles,PF,22,DEN,69,2,1351,264,537,.492,82,214,.383,182,323,.563,.568,101,145,.697,53,284,337,88,30,34,59,107,711
Shelvin Mack,PG,27,ORL,63,3,1228,159,370,.430,43,123,.350,116,247,.470,.488,64,87,.736,21,127,148,237,50,8,80,80,425
Josh Magette,PG,28,ATL,17,0,197,13,42,.310,7,21,.333,6,21,.286,.393,8,8,1.000,2,16,18,55,7,0,9,15,41
Ian Mahinmi,C,31,WAS,73,0,1091,135,237,.570,0,2,.000,135,235,.574,.570,88,124,.710,132,163,295,53,37,40,93,222,358
Thon Maker,C,20,MIL,71,12,1205,128,307,.417,30,100,.300,98,207,.473,.466,62,90,.689,74,148,222,46,38,52,42,158,348
Boban Marjanovic,C,29,TOT,34,1,275,65,124,.524,0,0,,65,124,.524,.524,55,67,.821,33,76,109,19,9,11,30,43,185
Boban Marjanovic,C,29,DET,19,1,171,41,79,.519,0,0,,41,79,.519,.519,36,45,.800,15,42,57,14,4,6,22,28,118
Boban Marjanovic,C,29,LAC,15,0,104,24,45,.533,0,0,,24,45,.533,.533,19,22,.864,18,34,52,5,5,5,8,15,67
Lauri Markkanen,PF,20,CHI,64,64,1925,349,810,.431,132,378,.349,217,432,.502,.512,129,152,.849,73,409,482,73,35,38,79,98,959
Jarell Martin,PF,23,MEM,72,35,1638,215,487,.441,32,96,.333,183,391,.468,.474,88,114,.772,96,217,313,72,39,49,85,206,550
Frank Mason,PG,23,SAC,50,2,959,142,370,.384,30,83,.361,112,287,.390,.424,91,111,.820,30,96,126,145,34,9,62,70,405
Mangok Mathiang,C,25,CHO,4,0,20,4,7,.571,0,0,,4,7,.571,.571,0,1,.000,3,7,10,0,1,0,0,5,8
Wesley Matthews,SF,31,DAL,63,62,2131,283,697,.406,153,402,.381,130,295,.441,.516,83,101,.822,28,170,198,172,76,16,83,140,802
Luc Mbah a Moute,PF,31,HOU,57,14,1478,156,322,.484,58,163,.356,98,159,.616,.575,62,89,.697,21,157,178,53,57,25,67,96,432
James Michael McAdoo,PF,25,PHI,3,0,18,2,7,.286,2,7,.286,0,0,,.429,2,2,1.000,0,2,2,0,0,1,1,1,8
Patrick McCaw,SG,22,GSW,57,10,961,92,225,.409,19,80,.238,73,145,.503,.451,26,34,.765,16,66,82,81,43,10,41,67,229
C.J. McCollum,SG,26,POR,76,76,2743,633,1407,.450,183,450,.407,450,957,.470,.515,199,237,.840,47,251,298,252,73,33,139,161,1648
T.J. McConnell,PG,25,PHI,70,1,1618,196,392,.500,25,59,.424,171,333,.514,.532,31,39,.795,35,180,215,286,87,12,110,118,448
Erik McCree,SF,24,UTA,4,0,8,0,2,.000,0,1,.000,0,1,.000,.000,0,0,,0,1,1,0,1,0,1,0,0
Chris McCullough,PF,22,WAS,19,0,90,18,42,.429,1,8,.125,17,34,.500,.440,9,14,.643,7,18,25,4,0,5,2,8,46
Doug McDermott,SF,26,TOT,77,3,1689,226,479,.472,89,203,.438,137,276,.496,.565,61,77,.792,40,153,193,75,19,14,54,119,602
Doug McDermott,SF,26,NYK,55,1,1172,151,328,.460,53,137,.387,98,191,.513,.541,40,53,.755,33,101,134,50,10,12,34,73,395
Doug McDermott,SF,26,DAL,22,2,517,75,151,.497,36,66,.545,39,85,.459,.616,21,24,.875,7,52,59,25,9,2,20,46,207
JaVale McGee,C,30,GSW,61,16,574,122,202,.604,0,6,.000,122,196,.622,.604,36,48,.750,50,104,154,32,19,56,23,87,280
Rodney McGruder,SG,26,MIA,14,0,237,28,58,.483,11,27,.407,17,31,.548,.578,2,4,.500,8,17,25,11,7,2,3,16,69
Trey McKinney-Jones,SG,27,IND,1,0,1,0,0,,0,0,,0,0,,,0,0,,0,0,0,0,0,0,0,0,0
Alfonzo McKinnie,SF,25,TOR,13,0,49,7,13,.538,3,8,.375,4,5,.800,.654,2,3,.667,0,6,6,1,1,1,3,8,19
Ben McLemore,SG,24,MEM,51,12,941,135,323,.418,48,136,.353,87,187,.465,.492,42,51,.824,30,90,120,44,35,14,55,127,360
Josh McRoberts,PF,30,DAL,2,0,6,0,1,.000,0,1,.000,0,0,,.000,0,0,,0,0,0,0,0,0,0,2,0
Jodie Meeks,SG,30,WAS,73,0,1078,147,372,.395,65,197,.330,82,175,.469,.483,99,113,.876,15,105,120,68,29,4,37,51,458
Salah Mejri,C,31,DAL,59,1,706,87,135,.644,0,3,.000,87,132,.659,.644,35,60,.583,82,159,241,33,22,66,37,118,209
Jordan Mickey,PF,23,MIA,22,3,277,37,78,.474,1,14,.071,36,64,.563,.481,12,18,.667,18,62,80,9,6,10,17,35,87
Khris Middleton,SF,26,MIL,77,77,2820,560,1199,.467,142,391,.363,418,808,.517,.526,295,336,.878,40,363,403,304,111,19,179,258,1557
C.J. Miles,SF,30,TOR,64,3,1213,210,545,.385,154,417,.369,56,128,.438,.527,72,86,.837,17,120,137,47,36,19,34,119,646
Darius Miller,SF,27,NOP,77,3,1823,203,456,.445,142,340,.418,61,116,.526,.601,53,61,.869,17,137,154,106,24,16,54,153,601
Malcolm Miller,SF,24,TOR,15,4,126,13,28,.464,8,21,.381,5,7,.714,.607,4,4,1.000,4,11,15,3,1,2,5,10,38
Patty Mills,PG,29,SAS,77,31,1951,258,624,.413,143,381,.375,115,243,.473,.528,100,112,.893,24,123,147,212,52,11,99,116,759
Paul Millsap,PF,32,DEN,33,32,976,182,377,.483,36,98,.367,146,279,.523,.531,98,139,.705,52,161,213,92,38,36,65,86,498
Nikola Mirotic,PF,26,TOT,50,9,1324,257,597,.430,115,315,.365,142,282,.504,.527,101,126,.802,50,295,345,73,38,35,57,94,730
Nikola Mirotic,PF,26,CHI,25,3,622,143,302,.474,69,161,.429,74,141,.525,.588,65,79,.823,18,141,159,39,15,13,31,45,420
Nikola Mirotic,PF,26,NOP,25,6,702,114,295,.386,46,154,.299,68,141,.482,.464,36,47,.766,32,154,186,34,23,22,26,49,310
Donovan Mitchell,SG,21,UTA,74,66,2476,556,1273,.437,175,519,.337,381,754,.505,.505,217,267,.813,45,222,267,270,111,26,203,203,1504
Naz Mitrou-Long,SG,24,UTA,1,0,1,1,1,1.000,1,1,1.000,0,0,,1.500,0,0,,0,0,0,0,0,0,0,0,3
Malik Monk,SG,19,CHO,59,0,754,123,363,.339,68,206,.330,55,157,.350,.433,21,27,.778,8,55,63,74,17,7,41,53,335
Greg Monroe,C,27,TOT,45,14,904,187,337,.555,0,0,,187,337,.555,.555,69,96,.719,97,207,304,89,37,19,82,81,443
Greg Monroe,C,27,MIL,5,0,79,16,33,.485,0,0,,16,33,.485,.485,2,4,.500,6,19,25,5,0,0,6,7,34
Greg Monroe,C,27,PHO,20,14,465,97,155,.626,0,0,,97,155,.626,.626,31,46,.674,50,110,160,50,16,6,40,40,225
Greg Monroe,C,27,BOS,20,0,360,74,149,.497,0,0,,74,149,.497,.497,36,46,.783,41,78,119,34,21,13,36,34,184
Luis Montero,SG,24,DET,2,0,8,0,1,.000,0,0,,0,1,.000,.000,0,0,,0,2,2,0,0,0,2,0,0
Ben Moore,PF,22,IND,2,0,9,0,0,,0,0,,0,0,,,0,0,,0,1,1,1,0,0,0,4,0
E'Twaun Moore,SG,28,NOP,77,75,2439,390,781,.499,117,280,.418,273,501,.545,.574,42,62,.677,55,175,230,171,72,11,98,171,939
Eric Moreland,PF,26,DET,62,1,706,52,100,.520,0,0,,52,100,.520,.520,10,26,.385,73,173,246,69,25,45,38,105,114
Jaylen Morris,SG,22,ATL,6,0,98,13,31,.419,2,9,.222,11,22,.500,.452,0,0,,2,14,16,7,2,1,6,2,28
Marcus Morris,PF,28,BOS,50,20,1331,243,559,.435,84,217,.387,159,342,.465,.510,112,138,.812,43,234,277,65,31,12,53,95,682
Markieff Morris,PF,28,WAS,68,68,1844,308,634,.486,70,188,.372,238,446,.534,.541,94,114,.825,70,314,384,129,53,38,122,205,780
Monte Morris,PG,22,DEN,3,0,25,4,6,.667,0,1,.000,4,5,.800,.667,2,2,1.000,0,2,2,7,3,0,1,1,10
Johnathan Motley,PF,22,DAL,7,0,49,12,20,.600,0,1,.000,12,19,.632,.600,7,17,.412,3,15,18,2,0,2,3,7,31
Timofey Mozgov,C,31,BRK,28,14,339,45,85,.529,4,18,.222,41,67,.612,.553,19,25,.760,28,59,87,8,5,11,31,37,113
Emmanuel Mudiay,PG,21,TOT,62,14,1218,203,517,.393,47,145,.324,156,372,.419,.438,98,129,.760,26,123,149,204,41,11,110,78,551
Emmanuel Mudiay,PG,21,DEN,42,0,752,129,322,.401,38,102,.373,91,220,.414,.460,63,78,.808,16,78,94,121,21,4,72,47,359
Emmanuel Mudiay,PG,21,NYK,20,14,466,74,195,.379,9,43,.209,65,152,.428,.403,35,51,.686,10,45,55,83,20,7,38,31,192
Shabazz Muhammad,SF-SG,25,TOT,40,2,380,75,167,.449,6,25,.240,69,142,.486,.467,29,39,.744,20,45,65,14,9,3,6,27,185
Shabazz Muhammad,SF,25,MIN,32,2,301,47,121,.388,4,19,.211,43,102,.422,.405,22,31,.710,15,30,45,7,5,2,5,23,120
Shabazz Muhammad,SG,25,MIL,8,0,79,28,46,.609,2,6,.333,26,40,.650,.630,7,8,.875,5,15,20,7,4,1,1,4,65
Xavier Munford,SG,25,MIL,6,0,21,1,6,.167,0,2,.000,1,4,.250,.167,1,2,.500,1,0,1,4,1,0,2,4,3
Dejounte Murray,PG,21,SAS,76,43,1607,251,566,.443,9,32,.281,242,534,.453,.451,82,118,.695,101,325,426,218,87,28,125,142,593
Jamal Murray,PG,20,DEN,76,75,2376,447,992,.451,158,410,.385,289,582,.497,.530,215,236,.911,76,204,280,251,75,25,164,160,1267
Mike Muscala,C,26,ATL,48,7,931,130,274,.474,55,140,.393,75,134,.560,.575,52,57,.912,52,151,203,44,29,24,37,77,367
Abdel Nader,SF,24,BOS,42,0,447,43,126,.341,22,60,.367,21,66,.318,.429,22,35,.629,10,48,58,22,13,8,29,43,130
Larry Nance,C,25,TOT,61,25,1351,230,390,.590,2,12,.167,228,378,.603,.592,86,131,.656,154,274,428,81,85,34,50,169,548
Larry Nance,C,25,LAL,42,17,922,152,253,.601,1,4,.250,151,249,.606,.603,55,87,.632,108,176,284,57,59,20,41,113,360
Larry Nance,C,25,CLE,19,8,429,78,137,.569,1,8,.125,77,129,.597,.573,31,44,.705,46,98,144,24,26,14,9,56,188
Shabazz Napier,PG,26,POR,69,9,1431,208,492,.423,75,202,.371,133,290,.459,.499,110,131,.840,24,132,156,143,78,14,87,78,601
Jameer Nelson,PG,35,TOT,50,0,1013,95,244,.389,41,124,.331,54,120,.450,.473,16,20,.800,13,91,104,179,27,4,67,81,247
Jameer Nelson,PG,35,NOP,43,0,897,84,205,.410,40,110,.364,44,95,.463,.507,13,17,.765,11,85,96,156,23,3,56,67,221
Jameer Nelson,PG,35,DET,7,0,116,11,39,.282,1,14,.071,10,25,.400,.295,3,3,1.000,2,6,8,23,4,1,11,14,26
Raul Neto,PG,25,UTA,39,0,478,67,147,.456,19,46,.413,48,101,.475,.520,26,33,.788,7,40,47,72,11,4,32,36,179
Georges Niang,PF,24,UTA,7,0,18,3,8,.375,0,3,.000,3,5,.600,.375,1,2,.500,2,3,5,3,2,0,2,1,7
Joakim Noah,C,32,NYK,7,0,40,5,10,.500,0,0,,5,10,.500,.500,2,4,.500,6,8,14,4,2,2,4,5,12
Nerlens Noel,C,23,DAL,30,6,472,55,105,.524,0,1,.000,55,104,.529,.524,21,28,.750,48,120,168,20,31,22,26,59,131
Lucas Nogueira,C,25,TOR,45,2,384,44,73,.603,5,18,.278,39,55,.709,.637,19,28,.679,16,67,83,18,20,42,15,45,112
Dirk Nowitzki,C,39,DAL,76,76,1876,341,744,.458,135,327,.413,206,417,.494,.549,96,106,.906,22,412,434,119,42,44,51,145,913
Frank Ntilikina,PG,19,NYK,73,4,1538,160,446,.359,44,140,.314,116,306,.379,.408,49,68,.721,31,128,159,225,60,14,121,170,413
Jusuf Nurkic,C,23,POR,74,74,1938,445,890,.500,0,7,.000,445,883,.504,.500,168,260,.646,168,476,644,133,61,103,170,230,1058
David Nwaba,SG,25,CHI,65,16,1497,180,363,.496,16,45,.356,164,318,.516,.518,129,198,.652,78,216,294,92,55,29,68,143,505
Johnny O'Bryant,PF,24,CHO,36,0,379,68,171,.398,14,43,.326,54,128,.422,.439,21,25,.840,29,65,94,14,8,6,15,45,171
Royce O'Neale,SF,24,UTA,64,4,1035,106,258,.411,36,107,.336,70,151,.464,.481,57,70,.814,24,185,209,88,36,15,52,94,305
Kyle O'Quinn,C,27,NYK,72,5,1260,201,341,.589,1,12,.083,200,329,.608,.591,91,118,.771,101,318,419,146,34,84,94,181,494
Semi Ojeleye,PF,23,BOS,67,0,1013,51,161,.317,34,112,.304,17,49,.347,.422,23,39,.590,33,102,135,19,19,2,21,79,159
Emeka Okafor,C,35,NOP,23,19,337,45,91,.495,0,0,,45,91,.495,.495,17,21,.810,46,66,112,7,7,25,11,29,107
Jahlil Okafor,C,22,TOT,27,0,336,70,129,.543,0,3,.000,70,126,.556,.543,21,29,.724,20,60,80,12,3,17,21,51,161
Jahlil Okafor,C,22,PHI,2,0,25,4,9,.444,0,0,,4,9,.444,.444,2,4,.500,4,5,9,1,0,2,3,7,10
Jahlil Okafor,C,22,BRK,25,0,311,66,120,.550,0,3,.000,66,117,.564,.550,19,25,.760,16,55,71,11,3,15,18,44,151
Victor Oladipo,SG,25,IND,71,71,2435,607,1282,.473,153,418,.366,454,864,.525,.533,290,358,.810,46,326,372,302,164,53,206,165,1657
Kelly Olynyk,PF,26,MIA,71,22,1678,297,592,.502,98,259,.378,199,333,.598,.584,126,166,.759,83,319,402,194,60,34,138,209,818
Cedi Osman,SF,22,CLE,56,9,582,79,154,.513,27,68,.397,52,86,.605,.601,20,35,.571,14,90,104,28,19,3,27,71,205
Kelly Oubre,SF,22,WAS,76,10,2087,304,739,.411,117,342,.342,187,397,.471,.491,178,214,.832,57,288,345,91,72,33,81,219,903
Zaza Pachulia,C,33,GSW,65,54,924,144,255,.565,0,1,.000,144,254,.567,.565,70,87,.805,85,223,308,105,36,16,70,118,358
Marcus Paige,PG,24,CHO,2,0,15,3,8,.375,1,3,.333,2,5,.400,.438,2,2,1.000,0,3,3,2,0,0,0,0,9
Georgios Papagiannis,C,20,SAC,16,0,118,17,41,.415,0,0,,17,41,.415,.415,0,0,,12,24,36,9,2,6,8,12,34
Jabari Parker,PF,22,MIL,26,1,591,126,258,.488,25,65,.385,101,193,.523,.537,32,42,.762,27,85,112,49,19,10,31,44,309
Tony Parker,PG,35,SAS,50,21,989,170,364,.467,9,34,.265,161,330,.488,.479,52,74,.703,6,85,91,188,28,1,63,47,401
Chandler Parsons,SF,29,MEM,36,8,691,108,234,.462,51,121,.421,57,113,.504,.571,17,27,.630,14,76,90,69,18,11,35,53,284
Patrick Patterson,PF,28,OKC,78,3,1222,102,257,.397,63,163,.387,39,94,.415,.519,37,43,.860,31,154,185,53,46,23,32,83,304
Justin Patton,C,20,MIN,1,0,4,1,2,.500,0,0,,1,2,.500,.500,0,0,,0,0,0,0,1,0,0,1,2
Brandon Paul,SG,26,SAS,61,2,558,51,121,.421,14,52,.269,37,69,.536,.479,21,41,.512,6,61,67,37,25,7,28,58,137
Chris Paul,PG,32,HOU,54,54,1720,338,739,.457,133,347,.383,205,392,.523,.547,198,216,.917,36,264,300,431,94,14,122,130,1007
Adreian Payne,PF,26,ORL,5,0,43,7,10,.700,2,3,.667,5,7,.714,.800,5,6,.833,2,7,9,0,2,0,2,6,21
Cameron Payne,PG,23,CHI,20,9,452,68,164,.415,26,72,.361,42,92,.457,.494,11,14,.786,12,40,52,82,21,9,28,36,173
Elfrid Payton,PG,23,TOT,63,63,1808,329,667,.493,30,92,.326,299,575,.520,.516,109,168,.649,64,210,274,393,83,22,168,147,797
Elfrid Payton,PG,23,ORL,44,44,1257,238,458,.520,25,67,.373,213,391,.545,.547,72,114,.632,47,127,174,275,64,16,114,97,573
Elfrid Payton,PG,23,PHO,19,19,551,91,209,.435,5,25,.200,86,184,.467,.447,37,54,.685,17,83,100,118,19,6,54,50,224
Gary Payton,PG,25,TOT,19,6,149,18,47,.383,2,15,.133,16,32,.500,.404,2,3,.667,8,15,23,13,3,3,3,23,40
Gary Payton,PG,25,MIL,12,6,106,13,33,.394,2,12,.167,11,21,.524,.424,2,3,.667,4,13,17,9,3,1,3,17,30
Gary Payton,PG,25,LAL,7,0,43,5,14,.357,0,3,.000,5,11,.455,.357,0,0,,4,2,6,4,0,2,0,6,10
London Perrantes,PG,23,CLE,13,0,33,1,6,.167,0,2,.000,1,4,.250,.167,1,3,.333,0,2,2,5,0,0,1,4,3
Alec Peters,PF,22,PHO,16,0,163,13,48,.271,8,40,.200,5,8,.625,.354,4,4,1.000,7,19,26,10,1,2,2,7,38
Marshall Plumlee,C,25,MIL,8,0,52,1,3,.333,0,0,,1,3,.333,.333,12,16,.750,4,13,17,2,0,1,3,10,14
Mason Plumlee,C,27,DEN,69,26,1363,208,349,.596,0,1,.000,208,348,.598,.596,76,169,.450,124,255,379,137,47,76,99,166,492
Miles Plumlee,C,29,ATL,50,34,833,100,170,.588,0,0,,100,170,.588,.588,23,52,.442,71,137,208,41,16,29,61,72,223
Jakob Poeltl,C,22,TOR,76,0,1395,224,351,.638,1,2,.500,223,349,.639,.640,55,94,.585,154,205,359,55,32,97,75,198,504
Quincy Pondexter,SF,29,CHI,23,1,196,14,49,.286,3,22,.136,11,27,.407,.316,14,17,.824,8,19,27,9,8,2,11,24,45
Otto Porter,SF,24,WAS,73,73,2324,424,848,.500,132,301,.439,292,547,.534,.578,102,123,.829,97,373,470,151,113,39,69,142,1082
Bobby Portis,PF,22,CHI,68,3,1531,352,755,.466,76,211,.360,276,544,.507,.517,119,153,.778,153,309,462,119,47,19,91,123,899
Kristaps Porzingis,PF,22,NYK,48,48,1553,390,889,.439,90,228,.395,300,661,.454,.489,218,275,.793,62,254,316,57,36,115,93,141,1088
Dwight Powell,C,26,DAL,75,21,1568,239,397,.602,22,66,.333,217,331,.656,.630,125,174,.718,128,288,416,81,62,30,57,179,625
Norman Powell,SG,24,TOR,64,17,990,140,346,.405,49,167,.293,91,179,.508,.475,32,39,.821,13,92,105,82,33,15,61,108,361
Alex Poythress,PF,24,IND,24,0,101,11,25,.440,4,11,.364,7,14,.500,.520,0,0,,7,10,17,2,3,1,2,16,26
Jacob Pullen,PG,28,PHI,3,0,6,1,2,.500,0,1,.000,1,1,1.000,.500,0,0,,0,0,0,0,0,0,1,0,2
Rodney Purvis,SG,23,ORL,10,2,154,18,49,.367,8,30,.267,10,19,.526,.449,7,7,1.000,0,10,10,6,3,2,6,14,51
Zhou Qi,C,22,HOU,16,0,87,5,27,.185,2,16,.125,3,11,.273,.222,7,10,.700,5,13,18,1,2,7,7,14,19
Tim Quarterman,SG,23,HOU,1,0,2,0,0,,0,0,,0,0,,,0,0,,0,1,1,1,0,0,0,0,0
Ivan Rabb,PF,20,MEM,31,1,375,61,105,.581,0,0,,61,105,.581,.581,17,22,.773,39,76,115,23,8,7,27,41,139
Julius Randle,C,23,LAL,76,43,2040,475,843,.563,10,43,.233,465,800,.581,.569,279,395,.706,169,438,607,186,41,45,193,256,1239
Zach Randolph,PF,36,SAC,59,57,1508,361,763,.473,51,147,.347,310,616,.503,.507,84,107,.785,97,300,397,127,42,10,116,119,857
Xavier Rathan-Mayes,SG,23,MEM,5,0,118,12,42,.286,1,14,.071,11,28,.393,.298,4,9,.444,0,5,5,18,6,3,11,18,29
J.J. Redick,SG,33,PHI,65,65,1964,362,801,.452,175,424,.413,187,377,.496,.561,181,200,.905,9,157,166,193,33,5,98,118,1080
Davon Reed,SG,22,PHO,17,0,185,17,57,.298,9,28,.321,8,29,.276,.377,5,8,.625,2,29,31,9,9,2,7,12,48
Willie Reed,C,27,TOT,42,5,428,81,121,.669,1,2,.500,80,119,.672,.674,32,55,.582,35,86,121,10,9,22,19,56,195
Willie Reed,C,27,LAC,39,5,419,80,120,.667,1,2,.500,79,118,.669,.671,32,55,.582,35,85,120,9,9,22,19,53,193
Willie Reed,C,27,DET,3,0,9,1,1,1.000,0,0,,1,1,1.000,1.000,0,0,,0,1,1,1,0,0,0,3,2
Josh Richardson,SF,24,MIA,76,76,2538,379,836,.453,123,324,.380,256,512,.500,.527,110,131,.840,67,198,265,217,114,68,136,192,991
Malachi Richardson,SG,22,TOT,26,4,324,30,90,.333,12,40,.300,18,50,.360,.400,17,22,.773,5,29,34,13,10,1,10,27,89
Malachi Richardson,SG,22,SAC,25,4,319,29,88,.330,12,39,.308,17,49,.347,.398,17,22,.773,5,28,33,13,10,1,10,27,87
Malachi Richardson,SG,22,TOR,1,0,5,1,2,.500,0,1,.000,1,1,1.000,.500,0,0,,0,1,1,0,0,0,0,0,2
Austin Rivers,SG,25,LAC,57,55,1926,326,758,.430,129,337,.383,197,421,.468,.515,91,143,.636,27,115,142,219,71,16,100,141,872
Andre Roberson,SG,26,OKC,39,39,1037,87,162,.537,8,36,.222,79,126,.627,.562,12,38,.316,75,110,185,46,45,35,30,89,194
Glenn Robinson,SF,24,IND,18,0,234,22,58,.379,5,19,.263,17,39,.436,.422,6,7,.857,8,18,26,12,11,1,2,11,55
Rajon Rondo,PG,31,NOP,60,58,1563,211,454,.465,46,137,.336,165,317,.521,.515,25,43,.581,28,212,240,476,61,10,137,109,493
Derrick Rose,PG,29,TOT,21,7,366,73,165,.442,6,27,.222,67,138,.486,.461,38,44,.864,13,20,33,34,5,4,32,15,190
Derrick Rose,PG,29,CLE,16,7,308,58,132,.439,6,24,.250,52,108,.481,.462,35,41,.854,10,19,29,26,3,4,28,14,157
Derrick Rose,PG,29,MIN,5,0,58,15,33,.455,0,3,.000,15,30,.500,.455,3,3,1.000,3,1,4,8,2,0,4,1,33
Terrence Ross,SG,26,ORL,22,20,576,72,177,.407,28,85,.329,44,92,.478,.486,26,35,.743,10,60,70,35,27,9,25,44,198
Terry Rozier,PG,23,BOS,76,12,1952,306,762,.402,149,383,.389,157,379,.414,.499,112,145,.772,60,289,349,210,78,15,71,118,873
Ricky Rubio,PG,27,UTA,72,72,2151,319,778,.410,88,255,.345,231,523,.442,.467,203,237,.857,40,290,330,388,115,11,200,198,929
D'Angelo Russell,PG,21,BRK,43,30,1104,249,606,.411,77,240,.321,172,366,.470,.474,96,128,.750,29,142,171,220,31,16,127,85,671
Domantas Sabonis,C,21,IND,69,19,1696,311,599,.519,12,33,.364,299,566,.528,.529,152,207,.734,157,382,539,142,34,28,130,202,786
JaKarr Sampson,SF,24,SAC,19,3,277,31,60,.517,5,9,.556,26,51,.510,.558,8,13,.615,17,44,61,9,8,19,7,41,75
Dario Saric,PF,23,PHI,74,69,2229,388,852,.455,152,381,.399,236,471,.501,.545,177,204,.868,150,357,507,193,51,20,146,155,1105
Tomas Satoransky,SG,26,WAS,68,28,1508,182,348,.523,44,94,.468,138,254,.543,.586,75,96,.781,62,145,207,269,50,14,77,124,483
Dennis Schroder,PG,24,ATL,67,67,2078,500,1146,.436,76,262,.290,424,884,.480,.469,225,265,.849,44,164,208,417,72,6,183,147,1301
Mike Scott,PF,29,WAS,71,1,1295,255,481,.530,62,151,.411,193,330,.585,.595,45,66,.682,42,184,226,72,22,10,75,136,617
Thabo Sefolosha,SF,33,UTA,38,6,806,118,240,.492,32,84,.381,86,156,.551,.558,44,54,.815,29,132,161,33,52,12,30,59,312
Wayne Selden,SG,23,MEM,35,9,692,116,269,.431,49,122,.402,67,147,.456,.522,44,59,.746,16,40,56,66,18,5,54,59,325
Ramon Sessions,PG,31,TOT,26,3,387,41,116,.353,8,26,.308,33,90,.367,.388,43,56,.768,6,32,38,75,14,2,30,29,133
Ramon Sessions,PG,31,NYK,13,3,167,17,53,.321,2,11,.182,15,42,.357,.340,12,15,.800,1,17,18,27,7,1,15,14,48
Ramon Sessions,PG,31,WAS,13,0,220,24,63,.381,6,15,.400,18,48,.375,.429,31,41,.756,5,15,20,48,7,1,15,15,85
Iman Shumpert,SG,27,CLE,14,6,276,22,58,.379,7,26,.269,15,32,.469,.440,11,15,.733,7,34,41,17,9,4,17,22,62
Pascal Siakam,PF,23,TOR,75,4,1537,236,461,.512,27,126,.214,209,335,.624,.541,53,82,.646,76,261,337,143,57,39,62,150,552
Xavier Silas,SG,30,BOS,1,0,0,0,0,,0,0,,0,0,,,0,0,,0,0,0,0,0,0,0,0,0
Ben Simmons,PG,21,PHI,75,75,2557,505,936,.540,0,11,.000,505,925,.546,.540,177,314,.564,136,467,603,613,128,65,256,193,1187
Jonathon Simmons,SG,28,ORL,69,50,2029,354,761,.465,69,204,.338,285,557,.512,.511,185,241,.768,61,178,239,171,58,16,146,175,962
Kobi Simmons,PG,20,MEM,27,7,496,60,142,.423,5,24,.208,55,118,.466,.440,16,16,1.000,13,30,43,51,18,5,32,49,141
Kyle Singler,SF,29,OKC,12,0,59,7,21,.333,2,5,.400,5,16,.313,.381,7,13,.538,1,9,10,2,1,0,3,4,23
Marcus Smart,SG,23,BOS,54,11,1614,189,515,.367,75,249,.301,114,266,.429,.440,97,133,.729,43,146,189,259,71,23,129,133,550
Dennis Smith,PG,20,DAL,66,66,1949,385,976,.394,103,325,.317,282,651,.433,.447,130,187,.695,47,197,244,331,65,16,189,145,1003
Ish Smith,PG,29,DET,77,35,1938,362,752,.481,27,81,.333,335,671,.499,.499,81,116,.698,27,186,213,330,60,17,100,134,832
J.R. Smith,SG,32,CLE,75,61,2127,227,565,.402,137,367,.373,90,198,.455,.523,39,56,.696,29,193,222,134,65,11,75,153,630
Jason Smith,C,31,WAS,31,2,276,43,112,.384,4,31,.129,39,81,.481,.402,17,19,.895,18,34,52,14,3,12,16,43,107
Josh Smith,PF,32,NOP,3,0,12,1,4,.250,0,0,,1,4,.250,.250,0,0,,3,1,4,0,0,0,0,3,2
Tony Snell,SG,26,MIL,70,54,1939,174,394,.442,102,247,.413,72,147,.490,.571,37,46,.804,9,121,130,91,45,24,35,110,487
Marreese Speights,C,30,ORL,50,3,647,132,335,.394,84,227,.370,48,108,.444,.519,40,53,.755,20,109,129,37,6,22,37,102,388
Nik Stauskas,SG,24,TOT,36,0,439,47,122,.385,34,83,.410,13,39,.333,.525,17,22,.773,3,51,54,29,8,3,21,19,145
Nik Stauskas,SG,24,PHI,6,0,45,1,4,.250,0,1,.000,1,3,.333,.250,2,2,1.000,0,1,1,1,4,0,4,3,4
Nik Stauskas,SG,24,BRK,30,0,394,46,118,.390,34,82,.415,12,36,.333,.534,15,20,.750,3,50,53,28,4,3,17,16,141
Lance Stephenson,SG,27,IND,77,6,1726,290,665,.436,63,213,.296,227,452,.502,.483,78,116,.672,57,326,383,215,43,15,129,164,721
David Stockton,PG,26,UTA,2,0,6,1,2,.500,1,2,.500,0,0,,.750,4,4,1.000,0,0,0,0,0,0,1,2,7
Julyan Stone,SG,29,CHO,19,0,91,2,5,.400,2,5,.400,0,0,,.600,1,2,.500,0,20,20,15,2,2,4,12,7
Caleb Swanigan,PF,20,POR,23,3,163,20,53,.377,1,8,.125,19,45,.422,.387,8,13,.615,15,29,44,14,5,3,14,32,49
Jayson Tatum,SF,19,BOS,76,76,2322,377,789,.478,99,228,.434,278,561,.496,.541,200,242,.826,48,341,389,119,71,57,108,163,1053
Isaiah Taylor,PG,23,ATL,62,6,1029,142,332,.428,17,66,.258,125,266,.470,.453,94,134,.701,20,65,85,180,31,10,72,104,395
Jeff Teague,PG,29,MIN,66,66,2166,324,732,.443,78,209,.373,246,523,.470,.496,187,222,.842,23,174,197,463,96,21,168,162,913
Marquis Teague,PG,24,MEM,2,0,53,3,10,.300,0,1,.000,3,9,.333,.300,2,5,.400,1,3,4,10,2,0,2,3,8
Mirza Teletovic,PF,32,MIL,10,0,159,25,57,.439,21,45,.467,4,12,.333,.623,0,0,,3,20,23,10,4,1,7,14,71
Garrett Temple,SG,31,SAC,65,35,1615,199,476,.418,89,227,.392,110,249,.442,.512,60,78,.769,22,130,152,124,57,27,79,135,547
Milos Teodosic,PG,30,LAC,45,36,1134,151,360,.419,88,232,.379,63,128,.492,.542,39,46,.848,16,110,126,209,23,5,97,103,429
Jason Terry,SG,40,MIL,46,4,744,53,137,.387,35,102,.343,18,35,.514,.515,8,9,.889,5,41,46,55,37,12,23,48,149
Daniel Theis,C,25,BOS,63,3,936,126,233,.541,18,58,.310,108,175,.617,.579,61,81,.753,90,184,274,56,30,48,56,157,331
Isaiah Thomas,PG,28,TOT,32,15,862,157,421,.373,55,188,.293,102,233,.438,.438,117,131,.893,17,50,67,153,15,3,95,58,486
Isaiah Thomas,PG,28,CLE,15,14,406,70,194,.361,22,87,.253,48,107,.449,.418,59,68,.868,7,24,31,68,9,2,41,25,221
Isaiah Thomas,PG,28,LAL,17,1,456,87,227,.383,33,101,.327,54,126,.429,.456,58,63,.921,10,26,36,85,6,1,54,33,265
Lance Thomas,PF,29,NYK,69,28,1275,94,245,.384,47,115,.409,47,130,.362,.480,41,49,.837,42,119,161,42,28,14,39,126,276
Klay Thompson,SG,27,GSW,68,68,2333,530,1079,.491,211,477,.442,319,602,.530,.589,79,95,.832,27,231,258,178,49,34,119,111,1350
Tristan Thompson,C,26,CLE,48,22,1003,123,218,.564,0,0,,123,218,.564,.564,42,76,.553,118,213,331,29,16,17,35,98,288
Sindarius Thornwell,SG,23,LAC,68,15,1041,87,204,.426,18,54,.333,69,150,.460,.471,53,77,.688,29,97,126,54,43,23,44,112,245
Anthony Tolliver,PF,32,DET,74,9,1588,189,424,.446,137,330,.415,52,94,.553,.607,97,119,.815,44,178,222,83,29,20,53,129,612
Karl-Anthony Towns,C,22,MIN,78,78,2770,601,1110,.541,117,276,.424,484,834,.580,.594,334,390,.856,225,731,956,187,61,112,155,267,1653
P.J. Tucker,SF,32,HOU,77,29,2141,160,410,.390,106,284,.373,54,126,.429,.520,43,60,.717,86,333,419,69,77,23,67,193,469
Evan Turner,SF,29,POR,74,35,1885,241,541,.445,39,121,.322,202,420,.481,.482,88,104,.846,29,201,230,162,40,27,92,144,609
Myles Turner,C,21,IND,60,57,1725,297,606,.490,55,147,.374,242,459,.527,.535,158,204,.775,91,313,404,84,35,113,89,170,807
Ekpe Udoh,C,30,UTA,59,3,783,58,115,.504,0,1,.000,58,114,.509,.504,42,56,.750,64,79,143,51,42,72,20,98,158
Tyler Ulis,PG,22,PHO,67,40,1526,193,501,.385,38,134,.284,155,367,.422,.423,72,88,.818,23,95,118,280,65,6,117,114,496
Jonas Valanciunas,C,25,TOR,72,72,1621,361,635,.569,29,68,.426,332,567,.586,.591,163,203,.803,171,446,617,78,29,65,109,185,914
Denzel Valentine,SG,24,CHI,77,37,2095,301,721,.417,143,370,.386,158,351,.450,.517,38,51,.745,48,345,393,244,65,11,99,185,783
Fred VanVleet,PG,23,TOR,71,0,1432,221,513,.431,101,244,.414,120,269,.446,.529,80,96,.833,24,152,176,224,66,18,69,124,623
Rashad Vaughn,SG,21,TOT,28,0,212,23,56,.411,14,37,.378,9,19,.474,.536,4,6,.667,3,18,21,13,5,3,6,15,64
Rashad Vaughn,SG,21,MIL,22,0,173,21,50,.420,13,35,.371,8,15,.533,.550,4,6,.667,2,15,17,12,4,3,4,12,59
Rashad Vaughn,SG,21,BRK,1,0,4,0,0,,0,0,,0,0,,,0,0,,0,0,0,1,0,0,0,1,0
Rashad Vaughn,SG,21,ORL,5,0,35,2,6,.333,1,2,.500,1,4,.250,.417,0,0,,1,3,4,0,1,0,2,2,5
Noah Vonleh,PF,22,TOT,53,16,868,104,232,.448,20,65,.308,84,167,.503,.491,36,56,.643,70,238,308,34,19,17,31,68,264
Noah Vonleh,PF,22,POR,33,12,476,47,96,.490,2,6,.333,45,90,.500,.500,23,31,.742,35,132,167,13,6,11,15,42,119
Noah Vonleh,PF,22,CHI,20,4,392,57,136,.419,18,59,.305,39,77,.506,.485,13,25,.520,35,106,141,21,13,6,16,26,145
Nikola Vucevic,C,27,ORL,53,53,1599,381,802,.475,64,201,.318,317,601,.527,.515,73,89,.820,97,393,490,174,53,58,104,138,899
Dwyane Wade,SG,36,TOT,63,3,1452,284,640,.444,31,102,.304,253,538,.470,.468,131,181,.724,49,192,241,215,58,44,132,119,730
Dwyane Wade,SG,36,CLE,46,3,1069,198,435,.455,23,70,.329,175,365,.479,.482,94,134,.701,39,142,181,163,42,32,92,84,513
Dwyane Wade,SG,36,MIA,17,0,383,86,205,.420,8,32,.250,78,173,.451,.439,37,47,.787,10,50,60,52,16,12,40,35,217
Dion Waiters,SG,26,MIA,30,30,918,163,410,.398,52,170,.306,111,240,.463,.461,51,69,.739,8,69,77,113,23,9,70,61,429
Kemba Walker,PG,27,CHO,76,76,2632,571,1323,.432,226,582,.388,345,741,.466,.517,353,409,.863,31,211,242,426,90,24,171,98,1721
John Wall,PG,27,WAS,38,38,1302,258,621,.415,55,154,.357,203,467,.435,.460,160,222,.721,22,113,135,357,50,42,137,71,731
Tyrone Wallace,PG,23,LAC,25,15,700,91,202,.450,10,31,.323,81,171,.474,.475,55,70,.786,17,76,93,58,23,12,34,68,247
Taurean Waller-Prince,SF,23,ATL,77,77,2325,376,896,.420,159,417,.381,217,479,.453,.508,139,166,.837,47,323,370,194,80,41,178,157,1050
Derrick Walton,PG,22,MIA,15,0,142,8,24,.333,7,17,.412,1,7,.143,.479,6,6,1.000,2,14,16,15,6,3,2,6,29
Jameel Warney,PF,24,DAL,3,0,27,7,12,.583,0,0,,7,12,.583,.583,3,5,.600,4,5,9,0,0,0,1,2,17
T.J. Warren,SF,24,PHO,65,65,2142,529,1063,.498,20,90,.222,509,973,.523,.507,193,255,.757,125,208,333,85,65,41,85,149,1271
Travis Wear,SF,27,LAL,13,0,172,22,57,.386,16,41,.390,6,16,.375,.526,8,8,1.000,0,30,30,4,3,4,4,23,68
James Webb,SF,24,BRK,9,0,108,5,21,.238,4,17,.235,1,4,.250,.333,0,0,,7,15,22,4,1,0,3,10,14
Briante Weber,PG,25,TOT,18,0,237,19,43,.442,4,11,.364,15,32,.469,.488,8,10,.800,8,27,35,22,18,5,15,28,50
Briante Weber,PG,25,HOU,13,0,118,9,22,.409,4,9,.444,5,13,.385,.500,4,4,1.000,3,15,18,13,10,3,7,18,26
Briante Weber,PG,25,MEM,5,0,119,10,21,.476,0,2,.000,10,19,.526,.476,4,6,.667,5,12,17,9,8,2,8,10,24
David West,C,37,GSW,68,0,933,207,359,.577,3,8,.375,204,351,.581,.581,58,76,.763,60,165,225,126,43,71,78,112,475
Russell Westbrook,PG,29,OKC,76,76,2760,722,1603,.450,91,309,.294,631,1294,.488,.479,396,540,.733,136,607,743,772,138,19,360,190,1931
Andrew White,SF,24,ATL,14,0,199,25,69,.362,18,45,.400,7,24,.292,.493,1,4,.250,4,28,32,5,3,1,7,11,69
Derrick White,PG,23,SAS,17,0,139,16,33,.485,8,13,.615,8,20,.400,.606,14,20,.700,5,21,26,9,4,3,6,8,54
Okaro White,PF,25,MIA,6,4,80,7,16,.438,4,11,.364,3,5,.600,.563,2,3,.667,3,8,11,2,1,1,1,6,20
Isaiah Whitehead,PG,22,BRK,16,0,180,40,86,.465,7,18,.389,33,68,.485,.506,13,19,.684,4,22,26,20,8,2,24,23,100
Hassan Whiteside,C,28,MIA,49,49,1255,284,520,.546,2,2,1.000,282,518,.544,.548,122,174,.701,156,411,567,49,37,83,90,115,692
Andrew Wiggins,SF,22,MIN,78,78,2832,550,1245,.442,107,324,.330,443,921,.481,.485,196,304,.645,73,260,333,148,87,49,135,156,1403
Jacob Wiley,PF,23,BRK,5,0,33,1,4,.250,1,2,.500,0,2,.000,.375,1,2,.500,2,9,11,2,1,0,0,4,4
Damien Wilkins,SF,38,IND,19,1,152,13,39,.333,4,18,.222,9,21,.429,.385,3,4,.750,5,11,16,9,2,1,5,7,33
Alan Williams,PF,25,PHO,4,0,67,7,18,.389,0,0,,7,18,.389,.389,6,9,.667,3,18,21,8,5,1,6,11,20
C.J. Williams,SG,27,LAC,33,15,613,76,168,.452,22,70,.314,54,98,.551,.518,13,16,.813,11,35,46,32,28,13,19,58,187
Derrick Williams,PF,26,LAL,2,0,9,1,4,.250,0,2,.000,1,2,.500,.250,0,0,,0,1,1,0,0,0,0,0,2
Lou Williams,SG,31,LAC,76,19,2490,565,1290,.438,183,509,.360,382,781,.489,.509,411,467,.880,39,156,195,406,83,19,226,104,1724
Marvin Williams,PF,31,CHO,74,74,1913,235,526,.447,111,281,.395,124,245,.506,.552,96,117,.821,70,281,351,85,53,33,63,110,677
Matt Williams,SG,24,MIA,3,0,11,2,6,.333,1,5,.200,1,1,1.000,.417,0,0,,0,1,1,0,0,0,1,1,5
Troy Williams,SF,23,TOT,21,1,307,51,109,.468,11,38,.289,40,71,.563,.518,20,30,.667,22,41,63,16,20,4,19,34,133
Troy Williams,SF,23,HOU,4,0,17,2,9,.222,0,5,.000,2,4,.500,.222,1,3,.333,1,3,4,1,1,0,1,2,5
Troy Williams,SF,23,NYK,17,1,290,49,100,.490,11,33,.333,38,67,.567,.545,19,27,.704,21,38,59,15,19,4,18,32,128
D.J. Wilson,PF,21,MIL,21,0,69,8,14,.571,2,5,.400,6,9,.667,.643,1,2,.500,1,8,9,3,2,1,4,5,19
Jamil Wilson,SF,27,LAC,15,10,274,38,81,.469,27,63,.429,11,18,.611,.636,2,4,.500,3,29,32,10,5,8,8,34,105
Justise Winslow,SF,21,MIA,63,25,1539,185,437,.423,48,118,.407,137,319,.429,.478,59,92,.641,59,284,343,135,50,33,69,132,477
Jeff Withey,C,27,DAL,9,0,39,6,16,.375,2,10,.200,4,6,.667,.438,1,2,.500,1,9,10,0,0,3,2,3,15
Nate Wolters,PG,26,UTA,5,0,19,1,6,.167,0,0,,1,6,.167,.167,0,0,,1,1,2,1,0,0,0,1,2
Brandan Wright,PF,30,TOT,28,1,381,59,102,.578,0,0,,59,102,.578,.578,21,33,.636,33,62,95,13,13,26,8,32,139
Brandan Wright,PF,30,MEM,27,1,366,57,99,.576,0,0,,57,99,.576,.576,21,33,.636,32,61,93,13,13,25,8,29,135
Brandan Wright,PF,30,HOU,1,0,15,2,3,.667,0,0,,2,3,.667,.667,0,0,,1,1,2,0,0,1,0,3,4
Delon Wright,PG,25,TOR,63,4,1298,184,391,.471,51,136,.375,133,255,.522,.536,88,106,.830,43,130,173,179,66,31,73,71,507
Guerschon Yabusele,PF,22,BOS,29,2,175,18,43,.419,10,29,.345,8,14,.571,.535,8,13,.615,14,26,40,14,2,2,11,21,54
James Young,SG,22,PHI,6,0,61,5,14,.357,3,10,.300,2,4,.500,.464,4,6,.667,0,2,2,2,0,0,1,4,17
Joe Young,PG,25,IND,50,1,520,74,171,.433,22,60,.367,52,111,.468,.497,22,29,.759,11,50,61,36,14,1,25,36,192
Nick Young,SG,32,GSW,75,8,1281,192,463,.415,117,310,.377,75,153,.490,.541,49,58,.845,19,91,110,34,36,7,39,91,550
Thaddeus Young,PF,29,IND,77,77,2514,405,831,.487,58,178,.326,347,653,.531,.522,50,84,.595,172,314,486,145,129,35,101,168,918
Cody Zeller,C,25,CHO,33,0,627,85,156,.545,2,3,.667,83,153,.542,.551,61,85,.718,67,110,177,31,14,21,33,81,233
Tyler Zeller,C,28,TOT,61,34,1008,170,312,.545,10,28,.357,160,284,.563,.561,55,77,.714,97,178,275,44,15,33,45,113,405
Tyler Zeller,C,28,BRK,42,33,703,125,229,.546,10,26,.385,115,203,.567,.568,40,60,.667,62,131,193,28,8,21,35,78,300
Tyler Zeller,C,28,MIL,19,1,305,45,83,.542,0,2,.000,45,81,.556,.542,15,17,.882,35,47,82,16,7,12,10,35,105
Paul Zipser,SF,23,CHI,54,12,824,81,234,.346,37,110,.336,44,124,.355,.425,19,26,.731,13,118,131,46,20,15,43,86,218
Ante Zizic,C,21,CLE,29,2,185,41,57,.719,0,0,,41,57,.719,.719,15,20,.750,22,31,53,5,1,13,10,27,97
Ivica Zubac,C,20,LAL,37,0,296,48,93,.516,0,0,,48,93,.516,.516,33,45,.733,33,58,91,15,6,9,20,34,129
