Player,Pos,Age,Tm,G,GS,MP,FG,FGA,FG%,3P,3PA,3P%,2P,2PA,2P%,eFG%,FT,FTA,FT%,ORB,DRB,TRB,AST,STL,BLK,TOV,PF,PTS
Alex Abrines,SG,24,OKC,70,8,1039,107,271,.395,78,203,.384,29,68,.426,.539,35,41,.854,24,82,106,27,36,8,25,113,327
Quincy Acy,PF,27,BRK,63,8,1229,110,323,.341,86,257,.335,24,66,.364,.474,46,56,.821,38,199,237,52,29,25,58,135,352
Steven Adams,C,24,OKC,70,70,2287,419,664,.631,0,2,.000,419,662,.633,.631,147,259,.568,358,276,634,76,85,76,113,202,985
Bam Adebayo,C,20,MIA,65,19,1304,166,323,.514,0,7,.000,166,316,.525,.514,121,171,.708,112,247,359,98,29,39,61,134,453
Arron Afflalo,SG,32,ORL,51,3,657,60,153,.392,25,65,.385,35,88,.398,.474,22,26,.846,4,62,66,29,4,9,21,54,167
Cole Aldrich,C,29,MIN,19,0,46,5,15,.333,0,0,,5,15,.333,.333,2,6,.333,3,10,13,2,2,1,1,11,12
LaMarcus Aldridge,C,32,SAS,69,69,2299,627,1234,.508,27,87,.310,600,1147,.523,.519,314,377,.833,227,349,576,142,35,81,106,151,1595
Jarrett Allen,C,19,BRK,65,24,1272,208,356,.584,3,13,.231,205,343,.598,.588,105,133,.789,137,213,350,46,26,67,73,130,524
Kadeem Allen,PG,25,BOS,11,0,32,1,6,.167,0,3,.000,1,3,.333,.167,3,4,.750,1,3,4,2,1,0,3,2,5
Tony Allen,SF,36,NOP,22,0,273,44,91,.484,4,12,.333,40,79,.506,.505,11,21,.524,20,27,47,9,11,3,19,49,103
Al-Farouq Aminu,PF,27,POR,62,60,1865,210,525,.400,117,306,.382,93,219,.425,.511,54,74,.730,84,381,465,76,67,36,67,121,591
Justin Anderson,SF,24,PHI,33,0,464,74,174,.425,28,86,.326,46,88,.523,.506,22,30,.733,20,59,79,23,13,5,14,51,198
Kyle Anderson,SF,24,SAS,68,62,1818,213,404,.527,16,50,.320,197,354,.556,.547,97,135,.719,79,296,375,187,104,52,92,104,539
Ryan Anderson,PF,29,HOU,63,50,1685,206,476,.433,130,337,.386,76,139,.547,.569,70,90,.778,92,230,322,59,24,21,42,121,612
Ike Anigbogu,C,19,IND,10,0,28,4,9,.444,0,0,,4,9,.444,.444,5,6,.833,5,4,9,0,1,3,2,1,13
Giannis Antetokounmpo,PF,23,MIL,70,70,2586,704,1312,.537,42,131,.321,662,1181,.561,.553,461,607,.759,146,548,694,335,103,102,204,213,1911
Carmelo Anthony,PF,33,OKC,72,72,2315,438,1080,.406,155,431,.360,283,649,.436,.477,136,178,.764,58,358,416,95,45,46,93,181,1167
OG Anunoby,SF,20,TOR,67,55,1338,143,312,.458,63,176,.358,80,136,.588,.559,35,55,.636,38,120,158,53,50,11,41,114,384
Ryan Arcidiacono,PG,23,CHI,17,0,155,7,17,.412,4,14,.286,3,3,1.000,.529,4,4,1.000,0,10,10,17,6,0,3,10,22
Trevor Ariza,SF,32,HOU,62,62,2119,252,604,.417,165,434,.380,87,170,.512,.554,74,85,.871,33,246,279,99,91,13,50,124,743
Darrell Arthur,PF,29,DEN,19,1,141,22,47,.468,8,23,.348,14,24,.583,.553,2,3,.667,3,12,15,9,8,3,15,22,54
Jamel Artis,SG,25,ORL,8,0,97,6,23,.261,0,7,.000,6,16,.375,.261,1,3,.333,2,10,12,11,0,1,0,5,13
Omer Asik,C,31,NOP,14,0,121,7,16,.438,0,0,,7,16,.438,.438,4,12,.333,7,30,37,2,1,2,5,14,18
D.J. Augustin,PG,30,ORL,67,28,1572,209,467,.448,104,245,.424,105,222,.473,.559,150,174,.862,25,113,138,259,50,0,109,88,672
Luke Babbitt,SF,28,TOT,48,13,683,90,205,.439,59,146,.404,31,59,.525,.583,17,22,.773,6,86,92,29,8,7,19,54,256
Luke Babbitt,SF,28,ATL,37,9,570,80,168,.476,49,111,.441,31,57,.544,.622,17,22,.773,5,76,81,26,7,5,15,47,226
Luke Babbitt,SF,28,MIA,11,4,113,10,37,.270,10,35,.286,0,2,.000,.405,0,0,,1,10,11,3,1,2,4,7,30
Dwayne Bacon,SG,22,CHO,52,6,695,70,186,.376,11,42,.262,59,144,.410,.406,20,25,.800,4,120,124,36,16,2,22,45,171
Ron Baker,SG,24,NYK,29,1,385,20,59,.339,11,33,.333,9,26,.346,.432,20,26,.769,5,25,30,47,26,6,18,33,71
Wade Baldwin,PG,21,POR,2,0,24,5,6,.833,1,1,1.000,4,5,.800,.917,5,9,.556,0,5,5,2,0,0,1,3,16
Lonzo Ball,PG,20,LAL,52,50,1780,203,564,.360,90,295,.305,113,269,.420,.440,32,71,.451,69,291,360,376,88,43,136,117,528
J.J. Barea,PG,33,DAL,67,8,1573,295,676,.436,112,308,.364,183,368,.497,.519,80,102,.784,14,183,197,425,34,3,140,82,782
Harrison Barnes,PF,25,DAL,72,72,2456,499,1118,.446,108,301,.359,391,817,.479,.495,244,295,.827,74,377,451,143,48,14,111,90,1350
Will Barton,SG,27,DEN,74,33,2412,412,921,.447,141,379,.372,271,542,.500,.524,157,195,.805,61,298,359,300,78,49,138,147,1122
Nicolas Batum,SG,29,CHO,58,58,1836,251,603,.416,86,254,.339,165,349,.473,.488,96,117,.821,50,230,280,319,63,21,114,67,684
Jerryd Bayless,SG,29,PHI,39,11,925,109,262,.416,54,146,.370,55,116,.474,.519,35,44,.795,15,65,80,54,23,6,46,91,307
Aron Baynes,C,31,BOS,74,60,1342,182,384,.474,0,12,.000,182,372,.489,.474,57,76,.750,109,282,391,81,18,47,74,184,421
Kent Bazemore,SG,28,ATL,65,65,1789,284,676,.420,108,274,.394,176,402,.438,.500,160,201,.796,25,223,248,228,100,45,157,147,836
Bradley Beal,SG,24,WAS,75,75,2725,631,1368,.461,181,486,.372,450,882,.510,.527,267,338,.790,57,273,330,343,89,34,200,141,1710
Malik Beasley,SG,21,DEN,60,0,579,72,177,.407,27,81,.333,45,96,.469,.483,20,29,.690,14,57,71,31,15,7,24,36,191
Michael Beasley,PF,29,NYK,69,25,1553,377,748,.504,29,74,.392,348,674,.516,.523,116,149,.779,90,303,393,113,31,40,135,137,899
Marco Belinelli,SG,31,TOT,72,1,1722,286,660,.433,126,336,.375,160,324,.494,.529,133,145,.917,18,110,128,127,56,9,76,77,831
Marco Belinelli,SG,31,ATL,52,1,1210,199,484,.411,92,247,.372,107,237,.451,.506,101,109,.927,13,86,99,103,46,3,54,41,591
Marco Belinelli,SG,31,PHI,20,0,512,87,176,.494,34,89,.382,53,87,.609,.591,32,36,.889,5,24,29,24,10,6,22,36,240
Jordan Bell,C,23,GSW,50,13,731,104,165,.630,0,3,.000,104,162,.642,.630,29,42,.690,56,132,188,95,33,53,45,89,237
DeAndre' Bembry,SF,23,ATL,21,0,364,40,101,.396,8,24,.333,32,77,.416,.436,15,25,.600,8,48,56,31,13,10,38,32,103
Dragan Bender,PF,20,PHO,76,31,1882,161,436,.369,103,290,.355,58,146,.397,.487,34,44,.773,34,274,308,122,22,47,105,154,459
Davis Bertans,PF,25,SAS,72,10,1061,156,358,.436,92,247,.372,64,111,.577,.564,40,49,.816,18,133,151,72,26,28,35,90,444
Patrick Beverley,SG,29,LAC,11,11,334,48,119,.403,24,60,.400,24,59,.407,.504,14,17,.824,16,29,45,32,18,5,25,34,134
Khem Birch,C,25,ORL,34,0,416,43,86,.500,0,0,,43,86,.500,.500,20,32,.625,52,73,125,22,11,13,18,43,106
Jabari Bird,SG,23,BOS,7,0,35,1,4,.250,0,2,.000,1,2,.500,.250,3,5,.600,2,2,4,1,1,0,1,2,5
Bismack Biyombo,C,25,ORL,74,23,1367,159,305,.521,0,1,.000,159,304,.523,.521,94,143,.657,128,294,422,57,18,89,79,141,412
Nemanja Bjelica,PF,29,MIN,61,18,1225,161,334,.482,70,164,.427,91,170,.535,.587,34,43,.791,44,205,249,78,41,12,48,128,426
Tarik Black,C,26,HOU,45,1,457,67,112,.598,0,8,.000,67,104,.644,.598,24,53,.453,58,79,137,11,19,25,32,96,158
Antonio Blakeney,SG,21,CHI,19,0,314,53,143,.371,15,52,.288,38,91,.418,.423,30,39,.769,4,29,33,20,7,1,11,19,151
Eric Bledsoe,PG,28,TOT,67,67,2096,412,893,.461,107,324,.330,305,569,.536,.521,228,293,.778,47,209,256,324,135,39,202,165,1159
Eric Bledsoe,PG,28,PHO,3,3,83,16,40,.400,4,13,.308,12,27,.444,.450,11,14,.786,3,4,7,9,4,2,10,6,47
Eric Bledsoe,PG,28,MIL,64,64,2013,396,853,.464,103,311,.331,293,542,.541,.525,217,279,.778,44,205,249,315,131,37,192,159,1112
Vander Blue,SG,25,LAL,5,0,45,1,5,.200,0,2,.000,1,3,.333,.200,1,2,.500,0,1,1,3,1,0,3,2,3
Bogdan Bogdanovic,SG,25,SAC,72,47,1996,315,705,.447,119,302,.394,196,403,.486,.531,97,115,.843,26,178,204,238,67,16,115,154,846
Bojan Bogdanovic,SF,28,IND,75,75,2320,377,797,.473,143,361,.396,234,436,.537,.563,172,198,.869,29,224,253,115,54,6,100,118,1069
Andrew Bogut,C,33,LAL,23,5,216,17,25,.680,0,0,,17,25,.680,.680,2,2,1.000,26,52,78,15,4,13,19,40,36
Joel Bolomboy,PF,24,MIL,6,0,38,3,6,.500,0,1,.000,3,5,.600,.500,3,6,.500,6,4,10,0,2,0,2,3,9
Devin Booker,SG,21,PHO,54,54,1865,455,1054,.432,147,384,.383,308,670,.460,.501,289,329,.878,26,218,244,253,47,14,194,168,1346
Trevor Booker,PF,30,TOT,62,5,1065,162,312,.519,8,28,.286,154,284,.542,.532,59,85,.694,104,187,291,75,26,20,57,111,391
Trevor Booker,PF,30,BRK,18,5,395,77,150,.513,3,12,.250,74,138,.536,.523,24,43,.558,38,81,119,38,8,5,30,43,181
Trevor Booker,PF,30,PHI,33,0,494,61,109,.560,2,7,.286,59,102,.578,.569,32,39,.821,47,75,122,27,16,11,20,51,156
Trevor Booker,PF,30,IND,11,0,176,24,53,.453,3,9,.333,21,44,.477,.481,3,3,1.000,19,31,50,10,2,4,7,17,54
Chris Boucher,PF,25,GSW,1,0,1,0,1,.000,0,1,.000,0,0,,.000,0,0,,0,1,1,0,0,0,0,0,0
Avery Bradley,SG,27,TOT,46,46,1433,259,625,.414,75,203,.369,184,422,.436,.474,63,82,.768,22,94,116,94,51,8,101,92,656
Avery Bradley,SG,27,DET,40,40,1268,233,570,.409,74,194,.381,159,376,.423,.474,61,80,.763,19,75,94,83,46,7,93,80,601
Avery Bradley,SG,27,LAC,6,6,165,26,55,.473,1,9,.111,25,46,.543,.482,2,2,1.000,3,19,22,11,5,1,8,12,55
Tony Bradley,C,20,UTA,9,0,29,3,11,.273,0,1,.000,3,10,.300,.273,2,2,1.000,4,7,11,1,0,0,0,1,8
Corey Brewer,SF,31,TOT,66,12,1033,121,265,.457,25,86,.291,96,179,.536,.504,60,82,.732,30,98,128,57,65,14,47,122,327
Corey Brewer,SF,31,LAL,54,2,694,78,172,.453,8,43,.186,70,129,.543,.477,34,51,.667,23,70,93,41,41,8,38,83,198
Corey Brewer,SF,31,OKC,12,10,339,43,93,.462,17,43,.395,26,50,.520,.554,26,31,.839,7,28,35,16,24,6,9,39,129
Malcolm Brogdon,PG,25,MIL,46,20,1404,238,489,.487,59,156,.378,179,333,.538,.547,75,85,.882,23,129,152,149,41,13,65,128,610
Aaron Brooks,PG,33,MIN,30,1,172,24,57,.421,9,25,.360,15,32,.469,.500,6,9,.667,6,9,15,18,6,0,9,23,63
Dillon Brooks,SF,22,MEM,75,67,2140,292,666,.438,83,229,.362,209,437,.478,.501,96,130,.738,44,180,224,110,63,15,108,224,763
MarShon Brooks,SG,29,MEM,1,0,21,7,12,.583,5,5,1.000,2,7,.286,.792,2,2,1.000,1,0,1,2,1,1,1,1,21
Bobby Brown,PG,33,HOU,20,0,115,19,58,.328,11,40,.275,8,18,.444,.422,1,2,.500,0,7,7,11,4,0,9,6,50
Jaylen Brown,SF,21,BOS,64,64,1967,334,724,.461,106,278,.381,228,446,.511,.535,135,209,.646,65,265,330,106,62,23,111,170,909
Lorenzo Brown,PG,27,TOR,13,0,114,9,25,.360,1,8,.125,8,17,.471,.380,2,2,1.000,0,10,10,12,4,0,2,5,21
Markel Brown,SG,26,HOU,4,0,31,2,7,.286,1,5,.200,1,2,.500,.357,0,0,,1,4,5,2,0,0,2,6,5
Sterling Brown,SG,22,MIL,48,4,701,78,187,.417,30,82,.366,48,105,.457,.497,19,22,.864,25,107,132,21,31,11,23,69,205
Nicolas Brussino,SF,24,ATL,4,0,10,0,2,.000,0,2,.000,0,0,,.000,0,0,,0,3,3,0,0,0,0,0,0
Thomas Bryant,C,20,LAL,11,0,34,3,9,.333,1,5,.200,2,4,.500,.389,4,6,.667,1,5,6,2,0,0,1,2,11
Reggie Bullock,SF,26,DET,59,49,1632,254,512,.496,118,265,.445,136,247,.551,.611,36,46,.783,23,119,142,91,45,13,45,65,662
Trey Burke,PG,25,NYK,30,3,578,158,302,.523,30,78,.385,128,224,.571,.573,26,42,.619,11,42,53,122,18,4,33,31,372
Alec Burks,SG,26,UTA,60,1,1012,163,397,.411,43,133,.323,120,264,.455,.465,105,122,.861,18,164,182,63,37,8,56,71,474
Jimmy Butler,SG,28,MIN,56,56,2077,417,882,.473,69,194,.356,348,688,.506,.512,340,393,.865,75,230,305,279,108,23,103,74,1243
Dwight Buycks,PG,28,DET,29,0,427,82,198,.414,15,45,.333,67,153,.438,.452,36,41,.878,12,29,41,59,19,2,39,39,215
Bruno Caboclo,SF,22,TOT,9,0,79,7,24,.292,2,14,.143,5,10,.500,.333,3,4,.750,6,10,16,5,3,3,2,8,19
Bruno Caboclo,SF,22,TOR,2,0,7,0,2,.000,0,2,.000,0,0,,.000,0,0,,0,1,1,1,1,0,0,1,0
Bruno Caboclo,SF,22,SAC,7,0,72,7,22,.318,2,12,.167,5,10,.500,.364,3,4,.750,6,9,15,4,2,3,2,7,19
Jose Calderon,PG,36,CLE,52,30,826,80,160,.500,38,82,.463,42,78,.538,.619,22,28,.786,12,63,75,110,25,1,39,74,220
Kentavious Caldwell-Pope,SG,24,LAL,66,66,2243,309,725,.426,149,382,.390,160,343,.466,.529,135,174,.776,57,306,363,144,100,13,88,130,902
Isaiah Canaan,PG-SG,26,TOT,20,1,422,52,137,.380,22,66,.333,30,71,.423,.460,46,51,.902,6,39,45,76,16,1,29,36,172
Isaiah Canaan,SG,26,HOU,1,0,4,0,1,.000,0,0,,0,1,.000,.000,0,0,,0,1,1,0,0,0,0,0,0
Isaiah Canaan,PG,26,PHO,19,1,418,52,136,.382,22,66,.333,30,70,.429,.463,46,51,.902,6,38,44,76,16,1,29,36,172
Clint Capela,C,23,HOU,68,68,1866,412,629,.655,0,1,.000,412,628,.656,.655,133,239,.556,224,521,745,64,52,127,99,178,957
DeMarre Carroll,SF,31,BRK,70,70,2099,318,758,.420,140,376,.372,178,382,.466,.512,184,240,.767,103,367,470,142,58,30,97,159,960
Vince Carter,SF,41,SAC,52,4,923,104,256,.406,53,151,.351,51,105,.486,.510,23,32,.719,15,110,125,61,41,26,32,87,284
Michael Carter-Williams,PG,26,CHO,52,2,835,76,229,.332,14,59,.237,62,170,.365,.362,73,89,.820,37,101,138,116,44,23,52,99,239
Alex Caruso,PG,23,LAL,29,0,381,31,73,.425,5,26,.192,26,47,.553,.459,14,20,.700,8,30,38,51,16,9,26,35,81
Omri Casspi,SF,29,GSW,53,7,740,120,207,.580,10,22,.455,110,185,.595,.604,50,69,.725,30,170,200,51,18,19,37,70,300
Willie Cauley-Stein,C,24,SAC,67,52,1862,341,691,.493,3,12,.250,338,679,.498,.496,141,224,.629,122,336,458,156,73,61,101,165,826
Tyler Cavanaugh,PF,23,ATL,38,1,509,65,145,.448,31,86,.360,34,59,.576,.555,17,21,.810,43,80,123,27,9,4,14,61,178
Mario Chalmers,PG,31,MEM,62,10,1353,159,420,.379,50,178,.281,109,242,.450,.438,107,125,.856,13,137,150,188,74,11,110,171,475
Tyson Chandler,C,35,PHO,46,46,1151,121,187,.647,0,0,,121,187,.647,.647,58,94,.617,134,284,418,53,16,27,59,106,300
Wilson Chandler,SF,30,DEN,68,65,2146,264,587,.450,82,228,.360,182,359,.507,.520,85,110,.773,96,262,358,151,41,36,88,144,695
Marquese Chriss,PF,20,PHO,68,45,1410,178,431,.413,54,180,.300,124,251,.494,.476,83,141,.589,69,285,354,78,48,65,96,191,493
Ian Clark,SG,26,NOP,69,2,1345,201,455,.442,53,178,.298,148,277,.534,.500,44,58,.759,10,108,118,99,28,10,54,113,499
Jordan Clarkson,SG,25,TOT,74,2,1746,400,888,.450,104,302,.344,296,586,.505,.509,141,177,.797,55,152,207,211,52,5,118,99,1045
Jordan Clarkson,SG,25,LAL,53,2,1256,299,667,.448,68,210,.324,231,457,.505,.499,105,132,.795,44,115,159,173,39,3,95,63,771
Jordan Clarkson,SG,25,CLE,21,0,490,101,221,.457,36,92,.391,65,129,.504,.538,36,45,.800,11,37,48,38,13,2,23,36,274
Gian Clavell,SG,24,DAL,7,0,64,6,18,.333,6,15,.400,0,3,.000,.500,2,2,1.000,1,6,7,3,2,0,2,8,20
Antonius Cleveland,SG,23,DAL,13,0,81,4,14,.286,0,1,.000,4,13,.308,.286,2,4,.500,2,8,10,2,6,4,2,11,10
John Collins,PF,20,ATL,67,19,1568,282,482,.585,10,30,.333,272,452,.602,.595,125,167,.749,163,315,478,73,41,72,91,198,699
Zach Collins,C,20,POR,59,1,916,99,248,.399,32,96,.333,67,152,.441,.464,24,37,.649,41,156,197,44,16,28,52,119,254
Kyle Collinsworth,SF,26,DAL,27,1,371,26,68,.382,4,13,.308,22,55,.400,.412,16,32,.500,25,58,83,38,15,6,18,35,72
Darren Collison,PG,30,IND,63,58,1871,290,588,.493,85,190,.447,205,398,.515,.565,121,138,.877,35,130,165,341,87,15,81,115,786
Nick Collison,PF,37,OKC,13,0,72,13,19,.684,0,0,,13,19,.684,.684,4,8,.500,6,13,19,4,0,0,7,7,30
Mike Conley,PG,30,MEM,12,12,373,64,168,.381,24,77,.312,40,91,.440,.452,53,66,.803,0,27,27,49,12,3,18,24,205
Pat Connaughton,SG,25,POR,75,5,1368,153,367,.417,68,197,.345,85,170,.500,.510,36,43,.837,31,114,145,86,20,21,40,111,410
Quinn Cook,PG,24,GSW,26,11,498,86,178,.483,29,69,.420,57,109,.523,.565,15,17,.882,6,50,56,57,7,1,24,40,216
Charles Cooke,SG,23,NOP,11,0,34,2,12,.167,1,7,.143,1,5,.200,.208,1,2,.500,0,2,2,1,1,0,1,0,6
Jack Cooley,PF,26,SAC,2,0,10,4,7,.571,0,0,,4,7,.571,.571,2,2,1.000,3,1,4,2,0,0,0,2,10
Matt Costello,C,24,SAS,4,0,32,2,4,.500,0,0,,2,4,.500,.500,0,0,,1,8,9,2,2,2,1,7,4
DeMarcus Cousins,C,27,NOP,48,48,1737,406,864,.470,104,294,.354,302,570,.530,.530,294,394,.746,105,512,617,257,79,76,242,183,1210
Robert Covington,PF,27,PHI,72,72,2292,313,753,.416,187,496,.377,126,257,.490,.540,108,127,.850,51,336,387,137,113,57,116,216,921
Allen Crabbe,SG,25,BRK,69,62,2030,301,758,.397,177,482,.367,124,276,.449,.514,95,112,.848,26,271,297,105,42,30,73,157,874
Torrey Craig,SF,27,DEN,32,4,515,56,117,.479,15,45,.333,41,72,.569,.543,22,35,.629,31,73,104,21,9,8,13,50,149
Jamal Crawford,SG,37,MIN,74,0,1508,287,687,.418,100,295,.339,187,392,.477,.491,99,110,.900,18,69,87,172,37,8,88,81,773
Jordan Crawford,SG,29,NOP,2,0,37,7,14,.500,4,5,.800,3,9,.333,.643,0,0,,2,1,3,9,0,1,4,6,18
Jae Crowder,SF,27,TOT,73,47,1934,247,599,.412,98,299,.328,149,300,.497,.494,113,138,.819,53,201,254,91,55,18,68,169,705
Jae Crowder,SF,27,CLE,53,47,1346,157,376,.418,62,189,.328,95,187,.508,.500,78,92,.848,41,132,173,58,41,12,42,124,454
Jae Crowder,SF,27,UTA,20,0,588,90,223,.404,36,110,.327,54,113,.478,.484,35,46,.761,12,69,81,33,14,6,26,45,251
Dante Cunningham,SF,30,TOT,67,25,1446,146,325,.449,53,151,.351,93,174,.534,.531,29,49,.592,69,199,268,42,37,25,30,102,374
Dante Cunningham,SF,30,NOP,51,24,1115,99,225,.440,35,108,.324,64,117,.547,.518,20,36,.556,50,143,193,26,27,16,16,75,253
Dante Cunningham,SF,30,BRK,16,1,331,47,100,.470,18,43,.419,29,57,.509,.560,9,13,.692,19,56,75,16,10,9,14,27,121
Stephen Curry,PG,29,GSW,51,51,1631,428,864,.495,212,501,.423,216,363,.595,.618,278,302,.921,36,225,261,310,80,8,153,114,1346
Troy Daniels,SG,26,PHO,75,11,1547,222,550,.404,175,439,.399,47,111,.423,.563,56,64,.875,11,110,121,47,24,5,53,135,675
Anthony Davis,PF,24,NOP,68,68,2475,715,1326,.539,52,152,.342,663,1174,.565,.559,442,530,.834,170,587,757,156,100,170,147,143,1924
Deyonta Davis,C,21,MEM,55,4,786,137,221,.620,0,0,,137,221,.620,.620,35,50,.700,64,145,209,33,12,33,26,112,309
Ed Davis,C,28,POR,75,0,1427,166,284,.585,0,1,.000,166,283,.587,.585,74,111,.667,180,374,554,39,32,49,63,180,406
Dewayne Dedmon,C,28,ATL,56,40,1373,223,417,.535,43,123,.350,180,294,.612,.586,58,74,.784,92,339,431,78,38,44,81,148,547
Sam Dekker,PF,23,LAC,68,1,813,114,237,.481,10,59,.169,104,178,.584,.502,35,51,.686,38,116,154,34,22,9,30,64,273
Malcolm Delaney,PG,28,ATL,54,3,1014,109,285,.382,46,124,.371,63,161,.391,.463,74,92,.804,9,91,100,163,35,6,66,82,338
Matthew Dellavedova,PG,27,MIL,37,3,702,55,149,.369,29,77,.377,26,72,.361,.466,23,25,.920,13,50,63,142,14,0,48,67,162
Luol Deng,SF,32,LAL,1,1,13,1,2,.500,0,0,,1,2,.500,.500,0,0,,0,0,0,1,1,0,1,0,2
DeMar DeRozan,SG,28,TOR,74,74,2519,603,1318,.458,84,265,.317,519,1053,.493,.489,436,529,.824,55,233,288,383,81,18,165,136,1726
Cheick Diallo,PF,21,NOP,45,0,496,89,156,.571,0,0,,89,156,.571,.571,46,58,.793,37,145,182,15,10,19,22,66,224
Gorgui Dieng,C,28,MIN,73,0,1254,174,365,.477,15,54,.278,159,311,.511,.497,76,98,.776,98,235,333,67,43,36,56,136,439
Spencer Dinwiddie,PG,24,BRK,74,57,2137,303,782,.387,128,395,.324,175,387,.452,.469,206,251,.821,39,202,241,483,63,23,114,176,940
Tyler Dorsey,SG,21,ATL,49,5,783,105,297,.354,55,162,.340,50,135,.370,.446,31,46,.674,14,94,108,67,13,4,29,49,296
Damyean Dotson,SG,23,NYK,38,2,327,44,106,.415,14,45,.311,30,61,.492,.481,10,14,.714,7,46,53,22,7,1,12,22,112
Milton Doyle,SG,24,BRK,6,0,63,7,25,.280,2,13,.154,5,12,.417,.320,2,3,.667,2,7,9,4,2,1,2,3,18
PJ Dozier,PG,21,OKC,2,0,3,1,2,.500,0,0,,1,2,.500,.500,0,0,,0,1,1,0,0,0,1,1,2
Goran Dragic,PG,31,MIA,71,71,2256,460,1024,.449,105,288,.365,355,736,.482,.500,212,264,.803,52,232,284,345,59,12,155,171,1237
Larry Drew,PG,27,TOT,9,0,65,7,22,.318,3,8,.375,4,14,.286,.386,0,0,,3,0,3,8,0,0,3,6,17
Larry Drew,PG,27,PHI,3,0,15,1,7,.143,0,3,.000,1,4,.250,.143,0,0,,1,0,1,2,0,0,1,2,2
Larry Drew,PG,27,NOP,6,0,50,6,15,.400,3,5,.600,3,10,.300,.500,0,0,,2,0,2,6,0,0,2,4,15
Andre Drummond,C,24,DET,73,73,2442,434,825,.526,0,8,.000,434,817,.531,.526,224,366,.612,374,793,1167,225,111,121,188,233,1092
Jared Dudley,PF,32,PHO,45,0,626,42,110,.382,28,75,.373,14,35,.400,.509,24,29,.828,8,77,85,74,22,9,26,78,136
Kris Dunn,PG,23,CHI,52,43,1525,286,666,.429,43,134,.321,243,532,.457,.462,84,115,.730,24,197,221,310,104,27,150,175,699
Kevin Durant,PF,29,GSW,61,61,2096,566,1090,.519,158,368,.429,408,722,.565,.592,314,354,.887,30,380,410,327,45,114,190,121,1604
Jarell Eddie,SF,26,TOT,3,0,9,0,2,.000,0,2,.000,0,0,,.000,0,0,,0,1,1,0,1,0,0,0,0
Jarell Eddie,SF,26,BOS,2,0,6,0,1,.000,0,1,.000,0,0,,.000,0,0,,0,1,1,0,1,0,0,0,0
Jarell Eddie,SF,26,CHI,1,0,3,0,1,.000,0,1,.000,0,0,,.000,0,0,,0,0,0,0,0,0,0,0,0
Henry Ellenson,PF,21,DET,31,0,197,31,94,.330,11,36,.306,20,58,.345,.388,9,12,.750,8,45,53,13,3,0,13,12,82
Wayne Ellington,SG,30,MIA,71,2,1895,262,650,.403,210,538,.390,52,112,.464,.565,65,76,.855,21,184,205,77,47,6,51,85,799
Joel Embiid,C,23,PHI,63,63,1912,510,1056,.483,66,214,.308,444,842,.527,.514,359,467,.769,143,547,690,199,40,111,234,209,1445
James Ennis,SF,27,TOT,66,22,1511,169,354,.477,47,139,.338,122,215,.567,.544,95,114,.833,72,146,218,67,45,18,53,128,480
James Ennis,SF,27,MEM,45,14,1053,108,222,.486,30,84,.357,78,138,.565,.554,64,73,.877,53,104,157,49,32,12,38,81,310
James Ennis,SF,27,DET,21,8,458,61,132,.462,17,55,.309,44,77,.571,.527,31,41,.756,19,42,61,18,13,6,15,47,170
Tyler Ennis,PG,23,LAL,46,11,499,63,156,.404,10,41,.244,53,115,.461,.436,14,20,.700,12,55,67,71,19,6,22,60,150
Jawun Evans,PG,21,LAC,48,4,778,89,253,.352,15,54,.278,74,199,.372,.381,38,49,.776,9,75,84,100,36,6,44,97,231
Tyreke Evans,PG,28,MEM,52,32,1607,366,809,.452,114,286,.399,252,523,.482,.523,164,209,.785,44,221,265,269,57,17,117,96,1010
Dante Exum,PG,22,UTA,7,0,89,17,34,.500,1,6,.167,16,28,.571,.515,10,12,.833,2,8,10,17,3,1,9,7,45
Kenneth Faried,PF,28,DEN,32,7,461,76,148,.514,0,1,.000,76,147,.517,.514,36,51,.706,68,85,153,18,12,13,23,51,188
Derrick Favors,C,26,UTA,70,70,1951,354,630,.562,12,51,.235,342,579,.591,.571,131,197,.665,180,324,504,95,52,70,84,149,851
Kay Felder,PG,22,TOT,15,0,137,20,68,.294,4,19,.211,16,49,.327,.324,11,12,.917,2,13,15,20,3,1,16,11,55
Kay Felder,PG,22,CHI,14,0,134,20,66,.303,4,18,.222,16,48,.333,.333,11,12,.917,1,13,14,20,3,1,15,11,55
Kay Felder,PG,22,DET,1,0,3,0,2,.000,0,1,.000,0,1,.000,.000,0,0,,1,0,1,0,0,0,1,0,0
Cristiano Felicio,C,25,CHI,48,10,782,103,170,.606,0,1,.000,103,169,.609,.606,42,64,.656,61,109,170,46,9,11,41,87,248
Raymond Felton,PG,33,OKC,76,2,1275,214,515,.416,75,210,.357,139,305,.456,.488,35,43,.814,25,122,147,195,46,14,70,84,538
Terrance Ferguson,SG,19,OKC,58,12,722,64,157,.408,34,108,.315,30,49,.612,.516,9,10,.900,19,24,43,17,23,10,10,79,171
Yogi Ferrell,SG,24,DAL,75,21,2155,289,672,.430,123,328,.375,166,344,.483,.522,79,99,.798,26,213,239,180,59,8,76,146,780
Dorian Finney-Smith,PF,24,DAL,15,7,253,21,54,.389,10,34,.294,11,20,.550,.481,8,11,.727,12,30,42,13,6,3,12,29,60
Bryn Forbes,SG,24,SAS,74,12,1416,194,462,.420,84,216,.389,110,246,.447,.511,44,68,.647,11,93,104,75,26,2,37,101,516
Evan Fournier,SF,25,ORL,57,57,1837,368,802,.459,127,335,.379,241,467,.516,.538,150,173,.867,23,157,180,165,47,16,95,138,1013
De'Aaron Fox,PG,20,SAC,67,54,1830,296,714,.415,41,133,.308,255,581,.439,.443,123,171,.719,27,144,171,286,65,17,158,151,756
Tim Frazier,PG,27,WAS,54,11,789,64,161,.398,16,54,.296,48,107,.449,.447,23,30,.767,18,88,106,184,42,7,55,91,167
Channing Frye,C,34,TOT,46,1,563,87,172,.506,31,91,.341,56,81,.691,.596,14,15,.933,10,100,110,28,17,12,17,58,219
Channing Frye,C,34,CLE,44,1,545,84,169,.497,30,90,.333,54,79,.684,.586,14,15,.933,10,100,110,28,17,12,17,54,212
Channing Frye,C,34,LAL,2,0,18,3,3,1.000,1,1,1.000,2,2,1.000,1.167,0,0,,0,0,0,0,0,0,0,4,7
Markelle Fultz,SG,19,PHI,6,0,104,15,45,.333,0,0,,15,45,.333,.333,7,14,.500,7,11,18,22,3,2,7,9,37
Danilo Gallinari,SF,29,LAC,19,19,615,98,241,.407,34,106,.321,64,135,.474,.477,73,77,.948,8,85,93,39,11,6,23,27,303
Langston Galloway,SG,26,DET,54,2,782,115,304,.378,68,197,.345,47,107,.439,.490,27,34,.794,12,71,83,53,30,5,17,38,325
Marc Gasol,C,33,MEM,69,69,2311,412,996,.414,99,304,.326,313,692,.452,.463,280,336,.833,74,499,573,289,50,99,184,175,1203
Pau Gasol,C,37,SAS,71,60,1702,274,597,.459,41,112,.366,233,485,.480,.493,150,198,.758,118,461,579,223,22,75,103,108,739
Rudy Gay,PF,31,SAS,51,6,1092,218,470,.464,32,101,.317,186,369,.504,.498,97,124,.782,68,193,261,65,38,34,73,89,565
Paul George,SF,27,OKC,73,73,2664,532,1228,.433,221,551,.401,311,677,.459,.523,298,365,.816,63,349,412,248,150,38,198,215,1583
Marcus Georges-Hunt,SG,23,MIN,40,0,218,20,46,.435,3,14,.214,17,32,.531,.467,13,21,.619,7,9,16,7,6,0,3,31,56
Taj Gibson,PF,32,MIN,76,76,2547,397,680,.584,7,34,.206,390,646,.604,.589,133,173,.769,179,359,538,95,58,54,85,202,934
Manu Ginobili,SG,40,SAS,60,0,1194,185,429,.431,57,176,.324,128,253,.506,.498,99,118,.839,19,109,128,147,40,16,94,116,526
Rudy Gobert,C,25,UTA,49,49,1605,248,398,.623,0,0,,248,398,.623,.623,188,268,.701,146,383,529,67,37,115,87,136,684
Aaron Gordon,PF,22,ORL,51,50,1711,339,765,.443,104,298,.349,235,467,.503,.511,146,208,.702,83,343,426,123,49,40,93,101,928
Eric Gordon,SG,29,HOU,66,29,2072,403,934,.431,212,586,.362,191,348,.549,.545,192,236,.814,23,141,164,148,42,27,126,108,1210
Marcin Gortat,C,33,WAS,75,75,1901,267,514,.519,0,0,,267,514,.519,.519,104,156,.667,165,409,574,140,37,56,91,159,638
Treveon Graham,SG,24,CHO,62,2,1033,96,221,.434,40,97,.412,56,124,.452,.525,41,57,.719,42,79,121,56,33,2,27,107,273
Jerami Grant,PF,23,OKC,75,1,1528,222,425,.522,29,105,.276,193,320,.603,.556,135,207,.652,83,217,300,55,27,67,52,146,608
Jerian Grant,PG,25,CHI,67,26,1498,181,433,.418,54,157,.344,127,276,.460,.480,129,170,.759,31,128,159,315,52,6,80,117,545
Josh Gray,PG,24,PHO,5,0,86,11,41,.268,3,13,.231,8,28,.286,.305,7,11,.636,2,8,10,12,8,2,7,8,32
Danny Green,SG,30,SAS,64,56,1659,206,519,.397,112,301,.372,94,218,.431,.505,40,51,.784,39,190,229,100,56,75,66,108,564
Draymond Green,PF,27,GSW,63,63,2066,259,572,.453,70,232,.302,189,340,.556,.514,121,157,.771,73,421,494,459,86,87,175,168,709
Gerald Green,SG,32,HOU,34,0,744,132,331,.399,86,236,.364,46,95,.484,.529,38,47,.809,13,94,107,21,20,12,20,71,388
JaMychal Green,PF,27,MEM,54,53,1522,222,485,.458,43,126,.341,179,359,.499,.502,80,111,.721,146,312,458,79,32,24,75,153,567
Jeff Green,PF,31,CLE,71,9,1648,265,566,.468,44,151,.291,221,415,.533,.507,187,217,.862,55,176,231,91,37,28,70,135,761
Blake Griffin,PF,28,TOT,58,58,1970,436,996,.438,111,322,.345,325,674,.482,.493,259,330,.785,73,355,428,334,41,18,165,139,1242
Blake Griffin,PF,28,LAC,33,33,1139,255,578,.441,64,187,.342,191,391,.488,.497,172,219,.785,46,216,262,179,30,9,99,78,746
Blake Griffin,PF,28,DET,25,25,831,181,418,.433,47,135,.348,134,283,.473,.489,87,111,.784,27,139,166,155,11,9,66,61,496
Daniel Hamilton,SG,22,OKC,5,0,26,5,11,.455,2,5,.400,3,6,.500,.545,0,0,,0,5,5,7,1,0,2,0,12
Tim Hardaway,SG,25,NYK,54,51,1785,342,816,.419,122,389,.314,220,427,.515,.494,141,172,.820,32,178,210,145,58,10,87,116,947
James Harden,SG,28,HOU,66,66,2341,603,1347,.448,249,679,.367,354,668,.530,.540,574,664,.864,37,317,354,577,120,46,284,157,2029
Maurice Harkless,SF,24,POR,59,36,1264,147,297,.495,49,118,.415,98,179,.547,.577,42,59,.712,46,116,162,53,48,43,40,103,385
Montrezl Harrell,C,24,LAC,69,3,1119,301,471,.639,0,4,.000,301,467,.645,.639,129,200,.645,95,179,274,59,31,46,61,129,731
Devin Harris,PG,34,TOT,64,1,1195,167,407,.410,68,198,.343,99,209,.474,.494,132,158,.835,12,103,115,137,45,12,69,149,534
Devin Harris,PG,34,DAL,44,1,807,118,284,.415,44,125,.352,74,159,.465,.493,93,112,.830,9,76,85,85,33,8,49,103,373
Devin Harris,PG,34,DEN,20,0,388,49,123,.398,24,73,.329,25,50,.500,.496,39,46,.848,3,27,30,52,12,4,20,46,161
Gary Harris,SG,23,DEN,65,65,2265,432,889,.486,155,388,.399,277,501,.553,.573,129,156,.827,37,137,174,193,120,15,118,119,1148
Joe Harris,SG,26,BRK,73,11,1839,278,572,.486,137,330,.415,141,242,.583,.606,79,95,.832,49,196,245,114,33,18,83,146,772
Tobias Harris,PF,25,TOT,73,73,2438,512,1109,.462,174,416,.418,338,693,.488,.540,163,195,.836,55,342,397,168,64,32,92,149,1361
Tobias Harris,PF,25,DET,48,48,1563,320,709,.451,113,276,.409,207,433,.478,.531,115,136,.846,36,208,244,94,34,15,51,91,868
Tobias Harris,PF,25,LAC,25,25,875,192,400,.480,61,140,.436,131,260,.504,.556,48,59,.814,19,134,153,74,30,17,41,58,493
Aaron Harrison,SG,23,DAL,3,1,66,5,18,.278,2,14,.143,3,4,.750,.333,4,5,.800,1,6,7,2,2,2,1,11,16
Andrew Harrison,PG,23,MEM,56,46,1326,181,429,.422,47,142,.331,134,287,.467,.477,124,159,.780,23,108,131,177,38,26,81,138,533
Shaquille Harrison,PG,24,PHO,17,1,238,35,77,.455,4,17,.235,31,60,.517,.481,22,30,.733,5,41,46,27,18,6,13,32,96
Josh Hart,SG,22,LAL,55,20,1182,131,284,.461,60,151,.397,71,133,.534,.567,42,64,.656,33,173,206,65,39,12,35,88,364
Udonis Haslem,C,37,MIA,13,0,66,3,14,.214,1,7,.143,2,7,.286,.250,0,0,,3,6,9,5,0,2,2,2,7
Nigel Hayes,SF,23,TOT,4,0,17,3,5,.600,2,4,.500,1,1,1.000,.800,1,1,1.000,0,0,0,2,0,0,1,0,9
Nigel Hayes,SF,23,LAL,2,0,11,1,3,.333,0,2,.000,1,1,1.000,.333,1,1,1.000,0,0,0,2,0,0,0,0,3
Nigel Hayes,SF,23,TOR,2,0,6,2,2,1.000,2,2,1.000,0,0,,1.500,0,0,,0,0,0,0,0,0,1,0,6
Gordon Hayward,SF,27,BOS,1,1,5,1,2,.500,0,1,.000,1,1,1.000,.500,0,0,,0,1,1,0,0,0,0,1,2
Reggie Hearn,SG,26,DET,2,0,3,1,1,1.000,1,1,1.000,0,0,,1.500,0,0,,0,0,0,0,0,0,0,0,3
Myke Henry,SF,25,MEM,15,0,279,30,78,.385,15,43,.349,15,35,.429,.481,6,10,.600,7,18,25,16,21,5,14,21,81
John Henson,C,27,MIL,70,63,1814,263,461,.570,1,6,.167,262,455,.576,.572,86,144,.597,140,340,480,101,37,100,81,187,613
Juan Hernangomez,PF,22,DEN,23,3,254,27,69,.391,12,44,.273,15,25,.600,.478,10,12,.833,17,36,53,10,6,3,8,20,76
Willy Hernangomez,C,23,TOT,42,1,376,71,131,.542,3,9,.333,68,122,.557,.553,33,59,.559,45,79,124,27,13,14,32,51,178
Willy Hernangomez,C,23,NYK,26,0,233,49,81,.605,1,5,.200,48,76,.632,.611,12,28,.429,22,45,67,21,8,7,26,32,111
Willy Hernangomez,C,23,CHO,16,1,143,22,50,.440,2,4,.500,20,46,.435,.460,21,31,.677,23,34,57,6,5,7,6,19,67
Mario Hezonja,SF,22,ORL,67,24,1419,237,529,.448,73,222,.329,164,307,.534,.517,73,89,.820,36,204,240,87,68,24,72,118,620
Isaiah Hicks,PF,23,NYK,12,0,146,17,37,.459,1,6,.167,16,31,.516,.473,5,8,.625,8,19,27,6,2,2,10,30,40
Buddy Hield,SG,24,SAC,74,12,1843,379,855,.443,161,382,.421,218,473,.461,.537,67,75,.893,47,237,284,137,70,21,112,134,986
Nene Hilario,C,35,HOU,49,4,717,133,228,.583,0,2,.000,133,226,.588,.583,63,96,.656,49,116,165,44,26,14,37,116,329
George Hill,PG,31,TOT,64,57,1761,229,499,.459,84,202,.416,145,297,.488,.543,108,138,.783,42,136,178,182,57,26,84,126,650
George Hill,PG,31,SAC,43,36,1143,153,326,.469,58,128,.453,95,198,.480,.558,77,99,.778,22,95,117,119,39,12,60,75,441
George Hill,PG,31,CLE,21,21,618,76,173,.439,26,74,.351,50,99,.505,.514,31,39,.795,20,41,61,63,18,14,24,51,209
Solomon Hill,SF,26,NOP,5,1,69,6,16,.375,3,8,.375,3,8,.375,.469,1,2,.500,2,4,6,11,2,0,1,5,16
Darrun Hilliard,SG,24,SAS,14,0,95,5,19,.263,0,6,.000,5,13,.385,.263,6,7,.857,0,7,7,11,2,0,4,7,16
Jrue Holiday,SG,27,NOP,74,74,2692,561,1149,.488,111,331,.335,450,818,.550,.537,174,222,.784,57,276,333,436,103,57,192,184,1407
Justin Holiday,SG,28,CHI,66,66,2120,264,716,.369,149,412,.362,115,304,.378,.473,127,154,.825,31,246,277,139,70,30,87,121,804
John Holland,SF,29,CLE,21,0,135,11,39,.282,7,25,.280,4,14,.286,.372,4,6,.667,4,15,19,4,6,2,5,9,33
Rondae Hollis-Jefferson,SF,23,BRK,61,52,1724,318,672,.473,12,49,.245,306,623,.491,.482,233,297,.785,97,312,409,149,55,40,106,134,881
Richaun Holmes,C,24,PHI,40,2,582,100,192,.521,4,29,.138,96,163,.589,.531,31,47,.660,47,126,173,47,15,21,22,78,235
Rodney Hood,SG,25,TOT,55,18,1494,301,710,.424,123,323,.381,178,387,.460,.511,100,116,.862,22,134,156,86,40,12,69,97,825
Rodney Hood,SG,25,UTA,39,12,1084,234,552,.424,102,262,.389,132,290,.455,.516,85,97,.876,14,97,111,65,30,7,63,64,655
Rodney Hood,SG,25,CLE,16,6,410,67,158,.424,21,61,.344,46,97,.474,.491,15,19,.789,8,37,45,21,10,5,6,33,170
Scotty Hopson,SG,28,DAL,1,0,8,0,1,.000,0,0,,0,1,.000,.000,1,2,.500,0,0,0,1,0,0,1,0,1
Al Horford,C,31,BOS,67,67,2120,344,700,.491,93,214,.435,251,486,.516,.558,75,100,.750,92,403,495,327,37,75,129,130,856
Danuel House,SG,24,PHO,17,0,196,25,67,.373,8,31,.258,17,36,.472,.433,16,19,.842,9,28,37,8,5,1,5,15,74
Dwight Howard,C,32,CHO,75,75,2295,471,849,.555,1,7,.143,470,842,.558,.555,309,537,.575,237,689,926,98,45,122,198,238,1252
Josh Huestis,PF,26,OKC,66,10,968,59,179,.330,32,113,.283,27,66,.409,.419,5,18,.278,42,118,160,20,15,43,26,81,155
R.J. Hunter,SG,24,HOU,4,0,15,0,4,.000,0,3,.000,0,1,.000,.000,0,0,,0,1,1,2,1,0,0,2,0
Vince Hunter,PF,23,MEM,4,0,7,3,5,.600,0,0,,3,5,.600,.600,0,0,,2,1,3,0,0,1,1,0,6
Serge Ibaka,PF,28,TOR,70,70,1919,344,722,.476,95,276,.344,249,446,.558,.542,90,111,.811,69,364,433,55,27,90,81,193,873
Andre Iguodala,SF,34,GSW,63,7,1601,146,314,.465,33,113,.292,113,201,.562,.518,55,87,.632,50,193,243,205,54,38,67,96,380
Ersan Ilyasova,PF,30,TOT,61,40,1509,236,521,.453,75,211,.355,161,310,.519,.525,85,109,.780,98,230,328,75,56,21,61,135,632
Ersan Ilyasova,PF,30,ATL,46,40,1175,184,401,.459,61,170,.359,123,231,.532,.535,72,90,.800,74,177,251,51,44,17,43,92,501
Ersan Ilyasova,PF,30,PHI,15,0,334,52,120,.433,14,41,.341,38,79,.481,.492,13,19,.684,24,53,77,24,12,4,18,43,131
Joe Ingles,SF,30,UTA,75,74,2362,305,659,.463,191,430,.444,114,229,.498,.608,62,75,.827,22,297,319,338,83,16,146,162,863
Brandon Ingram,SF,20,LAL,58,58,1948,353,754,.468,39,103,.379,314,651,.482,.494,192,279,.688,57,254,311,224,45,43,144,160,937
Kyrie Irving,PG,25,BOS,60,60,1931,534,1087,.491,166,407,.408,368,680,.541,.568,232,261,.889,33,194,227,306,65,17,140,122,1466
Jonathan Isaac,PF,20,ORL,25,8,494,49,129,.380,13,38,.342,36,91,.396,.430,15,21,.714,15,76,91,15,29,29,25,46,126
Wesley Iwundu,SF,23,ORL,55,5,819,75,172,.436,6,33,.182,69,139,.496,.453,28,36,.778,27,91,118,48,29,9,24,65,184
Jarrett Jack,PG,34,NYK,58,56,1483,178,419,.425,24,81,.296,154,338,.456,.453,58,70,.829,20,159,179,333,35,4,112,95,438
Demetrius Jackson,PG,23,TOT,14,0,78,7,18,.389,1,7,.143,6,11,.545,.417,1,2,.500,5,7,12,8,5,1,11,7,16
Demetrius Jackson,PG,23,HOU,12,0,63,4,14,.286,0,6,.000,4,8,.500,.286,0,0,,4,7,11,5,4,1,10,6,8
Demetrius Jackson,PG,23,PHI,2,0,15,3,4,.750,1,1,1.000,2,3,.667,.875,1,2,.500,1,0,1,3,1,0,1,1,8
Josh Jackson,SF,20,PHO,73,31,1820,350,838,.418,53,204,.260,297,634,.468,.449,160,257,.623,86,240,326,110,72,32,133,205,913
Justin Jackson,SF,22,SAC,62,35,1321,170,372,.457,51,157,.325,119,215,.553,.526,24,34,.706,25,143,168,64,26,11,35,66,415
Reggie Jackson,PG,27,DET,38,38,1007,206,474,.435,47,148,.318,159,326,.488,.484,83,100,.830,26,80,106,194,22,3,89,75,542
LeBron James,PF,33,CLE,75,75,2780,792,1447,.547,135,370,.365,657,1077,.610,.594,349,479,.729,89,557,646,680,111,70,318,128,2068
Mike James,PG,27,TOT,36,10,687,123,321,.383,26,98,.265,97,223,.435,.424,64,84,.762,13,77,90,126,28,7,49,48,336
Mike James,PG,27,PHO,32,10,669,121,312,.388,26,97,.268,95,215,.442,.429,64,84,.762,12,77,89,120,27,7,48,45,332
Mike James,PG,27,NOP,4,0,18,2,9,.222,0,1,.000,2,8,.250,.222,0,0,,1,0,1,6,1,0,1,3,4
Al Jefferson,C,33,IND,34,1,462,104,196,.531,0,1,.000,104,195,.533,.531,26,32,.813,30,104,134,29,16,23,20,63,234
Richard Jefferson,SF,37,DEN,20,0,163,12,27,.444,2,7,.286,10,20,.500,.481,4,7,.571,2,15,17,15,2,1,5,11,30
Brandon Jennings,PG,28,MIL,9,0,138,19,46,.413,8,24,.333,11,22,.500,.500,7,7,1.000,3,15,18,31,2,4,10,7,53
Jonas Jerebko,PF,30,UTA,67,19,1037,138,311,.444,56,140,.400,82,171,.480,.534,42,53,.792,51,183,234,40,23,10,24,117,374
Amir Johnson,C,30,PHI,66,10,996,118,219,.539,8,27,.296,110,192,.573,.557,45,77,.584,108,168,276,91,40,41,50,170,289
Brice Johnson,PF,23,TOT,18,0,98,20,42,.476,0,1,.000,20,41,.488,.476,3,5,.600,9,22,31,2,9,6,5,13,43
Brice Johnson,PF,23,LAC,9,0,38,7,11,.636,0,1,.000,7,10,.700,.636,2,2,1.000,2,11,13,1,6,2,4,7,16
Brice Johnson,PF,23,MEM,9,0,60,13,31,.419,0,0,,13,31,.419,.419,1,3,.333,7,11,18,1,3,4,1,6,27
Dakari Johnson,C,22,OKC,29,6,159,22,39,.564,0,0,,22,39,.564,.564,11,20,.550,16,18,34,8,6,8,3,27,55
James Johnson,PF,30,MIA,68,36,1807,285,567,.503,56,178,.315,229,389,.589,.552,100,146,.685,55,282,337,261,65,47,130,176,726
Joe Johnson,SF,36,TOT,48,3,1078,132,320,.413,36,129,.279,96,191,.503,.469,32,37,.865,12,138,150,74,18,6,43,59,332
Joe Johnson,SF,36,UTA,32,3,700,95,226,.420,23,84,.274,72,142,.507,.471,20,24,.833,12,95,107,45,12,6,31,32,233
Joe Johnson,SF,36,HOU,16,0,378,37,94,.394,13,45,.289,24,49,.490,.463,12,13,.923,0,43,43,29,6,0,12,27,99
Stanley Johnson,SF,21,DET,62,43,1681,180,489,.368,58,206,.282,122,283,.431,.427,99,125,.792,29,199,228,93,81,13,68,155,517
Tyler Johnson,PG,25,MIA,66,33,1881,286,657,.435,114,307,.371,172,350,.491,.522,101,124,.815,29,193,222,151,55,30,73,137,787
Wesley Johnson,SF,30,LAC,68,37,1415,141,350,.403,58,169,.343,83,181,.459,.486,41,55,.745,27,183,210,55,72,62,54,138,381
Nikola Jokic,C,22,DEN,68,66,2165,434,874,.497,97,244,.398,337,630,.535,.552,243,286,.850,183,530,713,406,79,52,189,189,1208
Damian Jones,C,22,GSW,8,0,33,3,4,.750,0,0,,3,4,.750,.750,2,2,1.000,3,3,6,0,0,1,2,6,8
Derrick Jones,SF,20,TOT,18,8,233,18,47,.383,2,16,.125,16,31,.516,.404,13,20,.650,19,15,34,8,4,13,6,23,51
Derrick Jones,SF,20,PHO,6,0,33,2,4,.500,0,2,.000,2,2,1.000,.500,5,6,.833,2,2,4,3,1,4,1,2,9
Derrick Jones,SF,20,MIA,12,8,200,16,43,.372,2,14,.143,14,29,.483,.395,8,14,.571,17,13,30,5,3,9,5,21,42
Jalen Jones,SF,24,TOT,13,0,107,14,36,.389,5,11,.455,9,25,.360,.458,6,8,.750,8,16,24,2,2,0,3,13,39
Jalen Jones,SF,24,NOP,4,0,19,1,4,.250,1,1,1.000,0,3,.000,.375,2,2,1.000,0,3,3,0,0,0,0,2,5
Jalen Jones,SF,24,DAL,9,0,88,13,32,.406,4,10,.400,9,22,.409,.469,4,6,.667,8,13,21,2,2,0,3,11,34
Tyus Jones,PG,21,MIN,76,10,1343,136,295,.461,37,109,.339,99,186,.532,.524,65,72,.903,16,112,128,211,85,5,52,101,374
DeAndre Jordan,C,29,LAC,70,70,2240,344,530,.649,0,0,,344,530,.649,.649,172,283,.608,296,782,1078,109,38,68,125,188,860
Cory Joseph,PG,26,IND,76,17,2067,238,560,.425,62,176,.352,176,384,.458,.480,69,92,.750,38,214,252,240,76,16,76,134,607
Frank Kaminsky,PF,24,CHO,73,4,1685,281,657,.428,96,249,.386,185,408,.453,.501,143,181,.790,44,220,264,117,35,18,60,86,801
Enes Kanter,C,25,NYK,71,71,1830,422,713,.592,0,2,.000,422,711,.594,.592,156,184,.848,273,507,780,105,36,37,122,187,1000
Luke Kennard,SG,21,DET,66,5,1271,175,398,.440,68,172,.395,107,226,.473,.525,51,59,.864,20,129,149,105,40,12,61,74,469
Michael Kidd-Gilchrist,SF,24,CHO,68,68,1699,261,520,.502,0,2,.000,261,518,.504,.502,104,155,.671,80,203,283,67,46,31,46,133,626
Sean Kilpatrick,SG,28,TOT,45,0,459,69,202,.342,28,102,.275,41,100,.410,.411,42,45,.933,3,62,65,33,9,2,27,26,208
Sean Kilpatrick,SG,28,BRK,16,0,183,25,86,.291,11,42,.262,14,44,.318,.355,18,19,.947,1,34,35,15,2,1,16,8,79
Sean Kilpatrick,SG,28,MIL,23,0,205,31,82,.378,13,46,.283,18,36,.500,.457,18,19,.947,1,24,25,15,5,1,9,15,93
Sean Kilpatrick,SG,28,LAC,4,0,38,7,18,.389,3,7,.429,4,11,.364,.472,2,2,1.000,0,2,2,3,0,0,1,2,19
Sean Kilpatrick,SG,28,CHI,2,0,33,6,16,.375,1,7,.143,5,9,.556,.406,4,5,.800,1,2,3,0,2,0,1,1,17
Maxi Kleber,PF,26,DAL,65,36,1062,127,271,.469,30,107,.280,97,164,.591,.524,41,55,.745,65,130,195,44,25,38,24,105,325
Furkan Korkmaz,SG,20,PHI,9,0,56,5,20,.250,3,12,.250,2,8,.250,.325,2,4,.500,2,6,8,3,1,1,2,6,15
Luke Kornet,PF,22,NYK,14,1,204,28,81,.346,16,54,.296,12,27,.444,.444,3,4,.750,10,32,42,14,5,11,3,12,75
Kyle Korver,SG,36,CLE,69,3,1501,214,467,.458,160,364,.440,54,103,.524,.630,61,69,.884,9,145,154,84,27,26,49,120,649
Kosta Koufos,C,28,SAC,71,13,1391,222,389,.571,0,0,,222,389,.571,.571,33,74,.446,149,323,472,87,47,32,49,146,477
Kyle Kuzma,PF,22,LAL,72,32,2218,431,956,.451,148,401,.369,283,555,.510,.528,134,189,.709,83,369,452,131,44,33,123,149,1144
Mindaugas Kuzminskas,SF,28,NYK,1,0,2,0,2,.000,0,0,,0,2,.000,.000,0,0,,0,0,0,0,0,0,0,0,0
Skal Labissiere,PF,21,SAC,58,26,1194,200,441,.454,18,46,.391,182,395,.461,.474,91,114,.798,94,179,273,69,24,48,66,126,509
Jeremy Lamb,SG,25,CHO,75,18,1857,359,789,.455,88,243,.362,271,546,.496,.511,177,206,.859,48,266,314,176,57,31,88,133,983
Shane Larkin,PG,25,BOS,50,1,686,76,194,.392,29,75,.387,47,119,.395,.466,30,33,.909,12,64,76,76,25,2,29,52,211
Joffrey Lauvergne,C,26,SAS,51,1,520,97,186,.522,0,5,.000,97,181,.536,.522,29,45,.644,62,106,168,38,9,3,33,45,223
Zach LaVine,SG,22,CHI,24,24,656,136,355,.383,42,123,.341,94,232,.405,.442,87,107,.813,9,85,94,72,24,4,43,55,401
Jake Layman,SF,23,POR,31,1,153,12,44,.273,4,19,.211,8,25,.320,.318,2,3,.667,4,10,14,10,6,4,5,13,30
T.J. Leaf,PF,20,IND,50,0,428,57,121,.471,18,39,.462,39,82,.476,.545,8,12,.667,26,51,77,8,5,4,10,43,140
Courtney Lee,SG,32,NYK,72,68,2203,320,714,.448,105,264,.398,215,450,.478,.522,114,124,.919,28,183,211,175,78,15,83,103,859
Damion Lee,SG,25,ATL,8,5,205,26,63,.413,8,29,.276,18,34,.529,.476,14,17,.824,3,30,33,16,11,1,6,12,74
"Walt Lemon, Jr.",PG,25,NOP,5,0,35,7,16,.438,1,1,1.000,6,15,.400,.469,2,3,.667,0,2,2,5,0,1,4,5,17
Alex Len,C,24,PHO,65,11,1292,191,339,.563,0,0,,191,339,.563,.563,149,214,.696,165,319,484,72,27,60,72,148,531
Kawhi Leonard,SF,26,SAS,9,9,210,52,111,.468,11,35,.314,41,76,.539,.518,31,38,.816,6,36,42,21,18,9,16,9,146
Meyers Leonard,C,25,POR,28,2,204,36,62,.581,9,21,.429,27,41,.659,.653,8,10,.800,10,45,55,13,5,0,7,28,89
Jon Leuer,PF,28,DET,8,0,136,15,36,.417,0,3,.000,15,33,.455,.417,13,15,.867,7,25,32,5,1,3,7,16,43
Caris LeVert,SF,23,BRK,65,9,1691,293,673,.435,79,223,.354,214,450,.476,.494,123,173,.711,51,187,238,265,72,20,140,145,788
DeAndre Liggins,SG,29,TOT,54,4,707,40,101,.396,19,52,.365,21,49,.429,.490,2,5,.400,7,68,75,45,37,14,20,79,101
DeAndre Liggins,SG,29,MIL,31,1,480,22,65,.338,11,36,.306,11,29,.379,.423,2,5,.400,5,44,49,27,27,10,13,61,57
DeAndre Liggins,SG,29,NOP,23,3,227,18,36,.500,8,16,.500,10,20,.500,.611,0,0,,2,24,26,18,10,4,7,18,44
Damian Lillard,PG,27,POR,67,67,2452,571,1295,.441,209,569,.367,362,726,.499,.522,444,484,.917,56,246,302,435,71,26,193,110,1795
Jeremy Lin,PG,29,BRK,1,1,25,5,12,.417,1,2,.500,4,10,.400,.458,7,7,1.000,0,0,0,4,0,0,3,3,18
Shaun Livingston,PG,32,GSW,66,7,1051,161,319,.505,0,4,.000,161,315,.511,.505,45,55,.818,32,88,120,126,33,20,55,110,367
Kevon Looney,C,21,GSW,60,2,769,92,160,.575,1,4,.250,91,156,.583,.578,36,68,.529,71,113,184,38,29,47,28,92,221
Brook Lopez,C,29,LAL,66,64,1554,334,716,.466,102,294,.347,232,422,.550,.538,98,143,.685,70,194,264,115,29,94,91,181,868
Robin Lopez,C,29,CHI,63,63,1673,339,641,.529,4,14,.286,335,627,.534,.532,68,90,.756,134,152,286,121,14,53,105,109,750
Kevin Love,C,29,CLE,53,53,1466,304,660,.461,118,289,.408,186,371,.501,.550,213,240,.888,97,393,490,92,37,22,81,107,939
Kyle Lowry,PG,31,TOR,71,71,2292,372,860,.433,221,540,.409,151,320,.472,.561,214,249,.859,64,335,399,486,80,15,163,174,1179
Timothe Luwawu-Cabarrot,SF,22,PHI,52,7,807,100,267,.375,53,158,.335,47,109,.431,.474,46,58,.793,14,58,72,54,12,5,38,97,299
Tyler Lydon,PF,21,DEN,1,0,2,0,0,,0,0,,0,0,,,0,0,,0,0,0,0,0,0,0,0,0
Trey Lyles,PF,22,DEN,67,2,1318,260,527,.493,82,211,.389,178,316,.563,.571,94,135,.696,51,276,327,82,30,32,59,106,696
Shelvin Mack,PG,27,ORL,61,3,1178,152,351,.433,42,114,.368,110,237,.464,.493,62,85,.729,19,123,142,229,49,8,78,78,408
Josh Magette,PG,28,ATL,16,0,178,11,36,.306,6,17,.353,5,19,.263,.389,8,8,1.000,2,14,16,50,7,0,7,14,36
Ian Mahinmi,C,31,WAS,72,0,1074,135,236,.572,0,2,.000,135,234,.577,.572,86,120,.717,130,162,292,50,36,39,93,219,356
Thon Maker,C,20,MIL,71,12,1205,128,307,.417,30,100,.300,98,207,.473,.466,62,90,.689,74,148,222,46,38,52,42,158,348
Boban Marjanovic,C,29,TOT,33,1,263,62,118,.525,0,0,,62,118,.525,.525,51,62,.823,31,69,100,19,8,11,30,41,175
Boban Marjanovic,C,29,DET,19,1,171,41,79,.519,0,0,,41,79,.519,.519,36,45,.800,15,42,57,14,4,6,22,28,118
Boban Marjanovic,C,29,LAC,14,0,92,21,39,.538,0,0,,21,39,.538,.538,15,17,.882,16,27,43,5,4,5,8,13,57
Lauri Markkanen,PF,20,CHI,62,62,1876,338,789,.428,126,365,.345,212,424,.500,.508,121,140,.864,73,395,468,72,33,37,76,97,923
Jarell Martin,PF,23,MEM,70,33,1578,208,471,.442,31,93,.333,177,378,.468,.475,87,112,.777,95,213,308,67,38,48,79,201,534
Frank Mason,PG,23,SAC,48,2,924,138,356,.388,28,76,.368,110,280,.393,.427,89,107,.832,30,92,122,140,34,9,61,69,393
Mangok Mathiang,C,25,CHO,4,0,20,4,7,.571,0,0,,4,7,.571,.571,0,1,.000,3,7,10,0,1,0,0,5,8
Wesley Matthews,SF,31,DAL,63,62,2131,283,697,.406,153,402,.381,130,295,.441,.516,83,101,.822,28,170,198,172,76,16,83,140,802
Luc Mbah a Moute,PF,31,HOU,55,14,1431,153,312,.490,57,158,.361,96,154,.623,.582,60,85,.706,20,152,172,52,55,24,63,94,423
James Michael McAdoo,PF,25,PHI,3,0,18,2,7,.286,2,7,.286,0,0,,.429,2,2,1.000,0,2,2,0,0,1,1,1,8
Patrick McCaw,SG,22,GSW,56,10,945,89,219,.406,19,79,.241,70,140,.500,.450,25,33,.758,16,64,80,81,40,9,41,67,222
C.J. McCollum,SG,26,POR,74,74,2669,620,1376,.451,180,439,.410,440,937,.470,.516,195,233,.837,46,245,291,242,69,32,134,153,1615
T.J. McConnell,PG,25,PHI,68,1,1585,191,383,.499,25,59,.424,166,324,.512,.531,31,39,.795,33,178,211,281,85,11,110,116,438
Erik McCree,SF,24,UTA,4,0,8,0,2,.000,0,1,.000,0,1,.000,.000,0,0,,0,1,1,0,1,0,1,0,0
Chris McCullough,PF,22,WAS,19,0,90,18,42,.429,1,8,.125,17,34,.500,.440,9,14,.643,7,18,25,4,0,5,2,8,46
Doug McDermott,SF,26,TOT,75,3,1655,219,466,.470,86,199,.432,133,267,.498,.562,61,77,.792,40,150,190,75,19,14,52,117,585
Doug McDermott,SF,26,NYK,55,1,1172,151,328,.460,53,137,.387,98,191,.513,.541,40,53,.755,33,101,134,50,10,12,34,73,395
Doug McDermott,SF,26,DAL,20,2,483,68,138,.493,33,62,.532,35,76,.461,.612,21,24,.875,7,49,56,25,9,2,18,44,190
JaVale McGee,C,30,GSW,59,15,558,118,192,.615,0,6,.000,118,186,.634,.615,35,46,.761,47,102,149,31,19,56,23,87,271
Rodney McGruder,SG,26,MIA,14,0,237,28,58,.483,11,27,.407,17,31,.548,.578,2,4,.500,8,17,25,11,7,2,3,16,69
Trey McKinney-Jones,SG,27,IND,1,0,1,0,0,,0,0,,0,0,,,0,0,,0,0,0,0,0,0,0,0,0
Alfonzo McKinnie,SF,25,TOR,13,0,49,7,13,.538,3,8,.375,4,5,.800,.654,2,3,.667,0,6,6,1,1,1,3,8,19
Ben McLemore,SG,24,MEM,49,12,889,126,301,.419,47,131,.359,79,170,.465,.497,40,49,.816,28,83,111,43,33,13,54,121,339
Josh McRoberts,PF,30,DAL,2,0,6,0,1,.000,0,1,.000,0,0,,.000,0,0,,0,0,0,0,0,0,0,2,0
Jodie Meeks,SG,30,WAS,71,0,1058,144,368,.391,63,194,.325,81,174,.466,.477,98,112,.875,15,102,117,67,28,4,35,51,449
Salah Mejri,C,31,DAL,59,1,706,87,135,.644,0,3,.000,87,132,.659,.644,35,60,.583,82,159,241,33,22,66,37,118,209
Jordan Mickey,PF,23,MIA,22,3,277,37,78,.474,1,14,.071,36,64,.563,.481,12,18,.667,18,62,80,9,6,10,17,35,87
Khris Middleton,SF,26,MIL,75,75,2739,546,1162,.470,139,379,.367,407,783,.520,.530,283,322,.879,39,351,390,296,104,18,173,248,1514
C.J. Miles,SF,30,TOR,63,3,1193,210,539,.390,154,412,.374,56,127,.441,.532,69,83,.831,17,115,132,46,36,19,30,114,643
Darius Miller,SF,27,NOP,75,3,1766,194,438,.443,136,329,.413,58,109,.532,.598,52,59,.881,14,135,149,102,22,16,53,149,576
Malcolm Miller,SF,24,TOR,15,4,126,13,28,.464,8,21,.381,5,7,.714,.607,4,4,1.000,4,11,15,3,1,2,5,10,38
Patty Mills,PG,29,SAS,76,30,1913,253,615,.411,140,375,.373,113,240,.471,.525,99,111,.892,24,118,142,208,52,11,99,113,745
Paul Millsap,PF,32,DEN,31,30,897,159,339,.469,32,90,.356,127,249,.510,.516,86,122,.705,43,148,191,85,37,35,60,78,436
Nikola Mirotic,PF,26,TOT,48,9,1276,247,575,.430,111,303,.366,136,272,.500,.526,101,126,.802,49,285,334,70,38,34,57,89,706
Nikola Mirotic,PF,26,CHI,25,3,622,143,302,.474,69,161,.429,74,141,.525,.588,65,79,.823,18,141,159,39,15,13,31,45,420
Nikola Mirotic,PF,26,NOP,23,6,654,104,273,.381,42,142,.296,62,131,.473,.458,36,47,.766,31,144,175,31,23,21,26,44,286
Donovan Mitchell,SG,21,UTA,72,64,2406,539,1243,.434,172,508,.339,367,735,.499,.503,211,257,.821,44,217,261,262,108,26,196,199,1461
Naz Mitrou-Long,SG,24,UTA,1,0,1,1,1,1.000,1,1,1.000,0,0,,1.500,0,0,,0,0,0,0,0,0,0,0,3
Malik Monk,SG,19,CHO,57,0,706,110,333,.330,61,188,.324,49,145,.338,.422,21,27,.778,8,52,60,68,16,5,32,51,302
Greg Monroe,C,27,TOT,44,14,888,184,330,.558,0,0,,184,330,.558,.558,69,96,.719,95,202,297,89,35,19,81,79,437
Greg Monroe,C,27,MIL,5,0,79,16,33,.485,0,0,,16,33,.485,.485,2,4,.500,6,19,25,5,0,0,6,7,34
Greg Monroe,C,27,PHO,20,14,465,97,155,.626,0,0,,97,155,.626,.626,31,46,.674,50,110,160,50,16,6,40,40,225
Greg Monroe,C,27,BOS,19,0,344,71,142,.500,0,0,,71,142,.500,.500,36,46,.783,39,73,112,34,19,13,35,32,178
Luis Montero,SG,24,DET,2,0,8,0,1,.000,0,0,,0,1,.000,.000,0,0,,0,2,2,0,0,0,2,0,0
Ben Moore,PF,22,IND,2,0,9,0,0,,0,0,,0,0,,,0,0,,0,1,1,1,0,0,0,4,0
E'Twaun Moore,SG,28,NOP,75,73,2379,383,764,.501,113,272,.415,270,492,.549,.575,42,62,.677,54,169,223,168,70,11,96,169,921
Eric Moreland,PF,26,DET,60,1,672,49,95,.516,0,0,,49,95,.516,.516,10,26,.385,71,159,230,66,23,42,35,100,108
Jaylen Morris,SG,22,ATL,6,0,98,13,31,.419,2,9,.222,11,22,.500,.452,0,0,,2,14,16,7,2,1,6,2,28
Marcus Morris,PF,28,BOS,49,20,1296,236,544,.434,83,213,.390,153,331,.462,.510,102,127,.803,43,225,268,62,31,10,52,93,657
Markieff Morris,PF,28,WAS,66,66,1804,303,623,.486,69,184,.375,234,439,.533,.542,94,114,.825,68,308,376,127,51,38,116,203,769
Monte Morris,PG,22,DEN,3,0,25,4,6,.667,0,1,.000,4,5,.800,.667,2,2,1.000,0,2,2,7,3,0,1,1,10
Johnathan Motley,PF,22,DAL,7,0,49,12,20,.600,0,1,.000,12,19,.632,.600,7,17,.412,3,15,18,2,0,2,3,7,31
Timofey Mozgov,C,31,BRK,28,14,339,45,85,.529,4,18,.222,41,67,.612,.553,19,25,.760,28,59,87,8,5,11,31,37,113
Emmanuel Mudiay,PG,21,TOT,61,14,1198,201,511,.393,47,144,.326,154,367,.420,.439,98,129,.760,25,122,147,202,41,11,107,77,547
Emmanuel Mudiay,PG,21,DEN,42,0,752,129,322,.401,38,102,.373,91,220,.414,.460,63,78,.808,16,78,94,121,21,4,72,47,359
Emmanuel Mudiay,PG,21,NYK,19,14,446,72,189,.381,9,42,.214,63,147,.429,.405,35,51,.686,9,44,53,81,20,7,35,30,188
Shabazz Muhammad,SF-SG,25,TOT,39,2,370,71,160,.444,6,24,.250,65,136,.478,.463,29,39,.744,20,44,64,14,9,3,6,26,177
Shabazz Muhammad,SF,25,MIN,32,2,301,47,121,.388,4,19,.211,43,102,.422,.405,22,31,.710,15,30,45,7,5,2,5,23,120
Shabazz Muhammad,SG,25,MIL,7,0,69,24,39,.615,2,5,.400,22,34,.647,.641,7,8,.875,5,14,19,7,4,1,1,3,57
Xavier Munford,SG,25,MIL,6,0,21,1,6,.167,0,2,.000,1,4,.250,.167,1,2,.500,1,0,1,4,1,0,2,4,3
Dejounte Murray,PG,21,SAS,75,42,1582,245,552,.444,9,31,.290,236,521,.453,.452,81,116,.698,100,320,420,217,86,28,123,140,580
Jamal Murray,PG,20,DEN,74,73,2295,435,965,.451,152,397,.383,283,568,.498,.530,203,224,.906,74,200,274,239,73,24,157,154,1225
Mike Muscala,C,26,ATL,46,7,879,124,257,.482,51,125,.408,73,132,.553,.582,50,55,.909,51,139,190,41,29,24,36,77,349
Abdel Nader,SF,24,BOS,41,0,440,43,124,.347,22,59,.373,21,65,.323,.435,20,33,.606,10,47,57,22,13,8,29,41,128
Larry Nance,C,25,TOT,59,23,1315,226,383,.590,1,11,.091,225,372,.605,.591,83,126,.659,151,266,417,77,81,34,48,165,536
Larry Nance,C,25,LAL,42,17,922,152,253,.601,1,4,.250,151,249,.606,.603,55,87,.632,108,176,284,57,59,20,41,113,360
Larry Nance,C,25,CLE,17,6,393,74,130,.569,0,7,.000,74,123,.602,.569,28,39,.718,43,90,133,20,22,14,7,52,176
Shabazz Napier,PG,26,POR,67,9,1394,205,480,.427,74,195,.379,131,285,.460,.504,107,128,.836,23,127,150,140,77,14,84,75,591
Jameer Nelson,PG,35,TOT,50,0,1013,95,244,.389,41,124,.331,54,120,.450,.473,16,20,.800,13,91,104,179,27,4,67,81,247
Jameer Nelson,PG,35,NOP,43,0,897,84,205,.410,40,110,.364,44,95,.463,.507,13,17,.765,11,85,96,156,23,3,56,67,221
Jameer Nelson,PG,35,DET,7,0,116,11,39,.282,1,14,.071,10,25,.400,.295,3,3,1.000,2,6,8,23,4,1,11,14,26
Raul Neto,PG,25,UTA,39,0,478,67,147,.456,19,46,.413,48,101,.475,.520,26,33,.788,7,40,47,72,11,4,32,36,179
Georges Niang,PF,24,UTA,6,0,15,3,6,.500,0,1,.000,3,5,.600,.500,0,0,,1,2,3,3,2,0,2,1,6
Joakim Noah,C,32,NYK,7,0,40,5,10,.500,0,0,,5,10,.500,.500,2,4,.500,6,8,14,4,2,2,4,5,12
Nerlens Noel,C,23,DAL,28,6,429,53,101,.525,0,1,.000,53,100,.530,.525,21,28,.750,45,104,149,17,30,20,23,56,127
Lucas Nogueira,C,25,TOR,45,2,384,44,73,.603,5,18,.278,39,55,.709,.637,19,28,.679,16,67,83,18,20,42,15,45,112
Dirk Nowitzki,C,39,DAL,74,74,1829,334,729,.458,133,320,.416,201,409,.491,.549,96,106,.906,22,399,421,116,42,44,50,142,897
Frank Ntilikina,PG,19,NYK,73,4,1538,160,446,.359,44,140,.314,116,306,.379,.408,49,68,.721,31,128,159,225,60,14,121,170,413
Jusuf Nurkic,C,23,POR,72,72,1885,432,863,.501,0,7,.000,432,856,.505,.501,163,255,.639,162,462,624,129,58,99,168,223,1027
David Nwaba,SG,25,CHI,63,14,1457,175,348,.503,16,43,.372,159,305,.521,.526,126,194,.649,76,211,287,86,52,29,65,139,492
Johnny O'Bryant,PF,24,CHO,36,0,379,68,171,.398,14,43,.326,54,128,.422,.439,21,25,.840,29,65,94,14,8,6,15,45,171
Royce O'Neale,SF,24,UTA,62,3,980,99,248,.399,35,104,.337,64,144,.444,.470,55,68,.809,24,174,198,81,32,15,48,89,288
Kyle O'Quinn,C,27,NYK,71,4,1228,198,336,.589,1,11,.091,197,325,.606,.591,89,116,.767,97,307,404,143,34,83,92,179,486
Semi Ojeleye,PF,23,BOS,66,0,995,50,158,.316,34,111,.306,16,47,.340,.424,23,39,.590,32,101,133,18,19,2,20,79,157
Emeka Okafor,C,35,NOP,21,17,321,44,88,.500,0,0,,44,88,.500,.500,17,21,.810,44,62,106,6,7,25,9,28,105
Jahlil Okafor,C,22,TOT,27,0,336,70,129,.543,0,3,.000,70,126,.556,.543,21,29,.724,20,60,80,12,3,17,21,51,161
Jahlil Okafor,C,22,PHI,2,0,25,4,9,.444,0,0,,4,9,.444,.444,2,4,.500,4,5,9,1,0,2,3,7,10
Jahlil Okafor,C,22,BRK,25,0,311,66,120,.550,0,3,.000,66,117,.564,.550,19,25,.760,16,55,71,11,3,15,18,44,151
Victor Oladipo,SG,25,IND,70,70,2397,596,1265,.471,150,412,.364,446,853,.523,.530,285,352,.810,45,323,368,290,159,52,204,161,1627
Kelly Olynyk,PF,26,MIA,70,22,1659,291,583,.499,96,257,.374,195,326,.598,.581,124,162,.765,81,313,394,192,60,34,136,208,802
Cedi Osman,SF,22,CLE,55,9,575,77,151,.510,26,66,.394,51,85,.600,.596,19,33,.576,14,90,104,27,18,3,27,70,199
Kelly Oubre,SF,22,WAS,74,10,2044,300,717,.418,116,330,.352,184,387,.475,.499,174,209,.833,57,283,340,89,70,32,78,215,890
Zaza Pachulia,C,33,GSW,64,54,919,144,255,.565,0,1,.000,144,254,.567,.565,70,87,.805,85,223,308,105,36,14,68,116,358
Marcus Paige,PG,24,CHO,2,0,15,3,8,.375,1,3,.333,2,5,.400,.438,2,2,1.000,0,3,3,2,0,0,0,0,9
Georgios Papagiannis,C,20,SAC,16,0,118,17,41,.415,0,0,,17,41,.415,.415,0,0,,12,24,36,9,2,6,8,12,34
Jabari Parker,PF,22,MIL,24,1,526,108,225,.480,20,54,.370,88,171,.515,.524,30,40,.750,24,75,99,44,17,10,30,38,266
Tony Parker,PG,35,SAS,49,21,976,169,361,.468,9,34,.265,160,327,.489,.481,50,72,.694,6,84,90,185,28,1,62,44,397
Chandler Parsons,SF,29,MEM,36,8,691,108,234,.462,51,121,.421,57,113,.504,.571,17,27,.630,14,76,90,69,18,11,35,53,284
Patrick Patterson,PF,28,OKC,76,3,1194,98,247,.397,59,155,.381,39,92,.424,.516,37,43,.860,31,149,180,52,43,22,32,81,292
Brandon Paul,SG,26,SAS,60,2,556,51,121,.421,14,52,.269,37,69,.536,.479,21,41,.512,6,61,67,37,25,7,28,58,137
Chris Paul,PG,32,HOU,54,54,1720,338,739,.457,133,347,.383,205,392,.523,.547,198,216,.917,36,264,300,431,94,14,122,130,1007
Adreian Payne,PF,26,ORL,5,0,43,7,10,.700,2,3,.667,5,7,.714,.800,5,6,.833,2,7,9,0,2,0,2,6,21
Cameron Payne,PG,23,CHI,18,7,405,62,152,.408,22,66,.333,40,86,.465,.480,11,14,.786,12,36,48,74,21,7,23,32,157
Elfrid Payton,PG,23,TOT,63,63,1808,329,667,.493,30,92,.326,299,575,.520,.516,109,168,.649,64,210,274,393,83,22,168,147,797
Elfrid Payton,PG,23,ORL,44,44,1257,238,458,.520,25,67,.373,213,391,.545,.547,72,114,.632,47,127,174,275,64,16,114,97,573
Elfrid Payton,PG,23,PHO,19,19,551,91,209,.435,5,25,.200,86,184,.467,.447,37,54,.685,17,83,100,118,19,6,54,50,224
Gary Payton,PG,25,TOT,19,6,149,18,47,.383,2,15,.133,16,32,.500,.404,2,3,.667,8,15,23,13,3,3,3,23,40
Gary Payton,PG,25,MIL,12,6,106,13,33,.394,2,12,.167,11,21,.524,.424,2,3,.667,4,13,17,9,3,1,3,17,30
Gary Payton,PG,25,LAL,7,0,43,5,14,.357,0,3,.000,5,11,.455,.357,0,0,,4,2,6,4,0,2,0,6,10
London Perrantes,PG,23,CLE,12,0,32,1,5,.200,0,1,.000,1,4,.250,.200,1,3,.333,0,2,2,5,0,0,1,4,3
Alec Peters,PF,22,PHO,14,0,124,11,41,.268,7,35,.200,4,6,.667,.354,3,3,1.000,5,16,21,9,0,2,1,5,32
Marshall Plumlee,C,25,MIL,7,0,45,1,3,.333,0,0,,1,3,.333,.333,12,16,.750,4,12,16,2,0,1,3,8,14
Mason Plumlee,C,27,DEN,67,26,1346,205,344,.596,0,1,.000,205,343,.598,.596,73,166,.440,121,251,372,135,47,75,97,163,483
Miles Plumlee,C,29,ATL,48,34,799,93,162,.574,0,0,,93,162,.574,.574,22,50,.440,63,127,190,38,16,28,59,70,208
Jakob Poeltl,C,22,TOR,75,0,1375,224,350,.640,1,2,.500,223,348,.641,.641,55,94,.585,154,202,356,55,32,96,75,198,504
Quincy Pondexter,SF,29,CHI,23,1,196,14,49,.286,3,22,.136,11,27,.407,.316,14,17,.824,8,19,27,9,8,2,11,24,45
Otto Porter,SF,24,WAS,71,71,2255,407,821,.496,123,284,.433,284,537,.529,.571,102,123,.829,92,364,456,149,111,37,68,139,1039
Bobby Portis,PF,22,CHI,66,3,1495,343,737,.465,71,204,.348,272,533,.510,.514,117,150,.780,151,302,453,117,46,17,90,118,874
Kristaps Porzingis,PF,22,NYK,48,48,1553,390,889,.439,90,229,.393,300,660,.455,.489,218,275,.793,62,254,316,57,36,115,93,141,1088
Dwight Powell,C,26,DAL,73,19,1525,236,393,.601,20,64,.313,216,329,.657,.626,121,168,.720,124,282,406,79,62,29,53,171,613
Norman Powell,SG,24,TOR,63,17,982,139,343,.405,49,165,.297,90,178,.506,.477,32,39,.821,12,92,104,82,33,15,61,107,359
Alex Poythress,PF,24,IND,24,0,101,11,25,.440,4,11,.364,7,14,.500,.520,0,0,,7,10,17,2,3,1,2,16,26
Jacob Pullen,PG,28,PHI,3,0,6,1,2,.500,0,1,.000,1,1,1.000,.500,0,0,,0,0,0,0,0,0,1,0,2
Rodney Purvis,SG,23,ORL,8,1,120,16,40,.400,7,23,.304,9,17,.529,.488,7,7,1.000,0,8,8,4,2,2,6,13,46
Zhou Qi,C,22,HOU,16,0,87,5,27,.185,2,16,.125,3,11,.273,.222,7,10,.700,5,13,18,1,2,7,7,14,19
Ivan Rabb,PF,20,MEM,29,1,338,56,95,.589,0,0,,56,95,.589,.589,17,22,.773,36,62,98,22,8,6,26,37,129
Julius Randle,C,23,LAL,74,41,1975,465,822,.566,9,42,.214,456,780,.585,.571,263,373,.705,165,427,592,183,40,43,188,249,1202
Zach Randolph,PF,36,SAC,59,57,1508,361,763,.473,51,147,.347,310,616,.503,.507,84,107,.785,97,300,397,127,42,10,116,119,857
Xavier Rathan-Mayes,SG,23,MEM,5,0,118,12,42,.286,1,14,.071,11,28,.393,.298,4,9,.444,0,5,5,18,6,3,11,18,29
J.J. Redick,SG,33,PHI,63,63,1911,347,772,.449,169,413,.409,178,359,.496,.559,178,196,.908,9,153,162,188,33,5,92,116,1041
Davon Reed,SG,22,PHO,17,0,185,17,57,.298,9,28,.321,8,29,.276,.377,5,8,.625,2,29,31,9,9,2,7,12,48
Willie Reed,C,27,TOT,42,5,428,81,121,.669,1,2,.500,80,119,.672,.674,32,55,.582,35,86,121,10,9,22,19,56,195
Willie Reed,C,27,LAC,39,5,419,80,120,.667,1,2,.500,79,118,.669,.671,32,55,.582,35,85,120,9,9,22,19,53,193
Willie Reed,C,27,DET,3,0,9,1,1,1.000,0,0,,1,1,1.000,1.000,0,0,,0,1,1,1,0,0,0,3,2
Josh Richardson,SF,24,MIA,75,75,2499,373,821,.454,122,319,.382,251,502,.500,.529,110,131,.840,67,191,258,214,112,68,134,190,978
Malachi Richardson,SG,22,TOT,26,4,324,30,90,.333,12,40,.300,18,50,.360,.400,17,22,.773,5,29,34,13,10,1,10,27,89
Malachi Richardson,SG,22,SAC,25,4,319,29,88,.330,12,39,.308,17,49,.347,.398,17,22,.773,5,28,33,13,10,1,10,27,87
Malachi Richardson,SG,22,TOR,1,0,5,1,2,.500,0,1,.000,1,1,1.000,.500,0,0,,0,1,1,0,0,0,0,0,2
Austin Rivers,SG,25,LAC,55,53,1860,318,735,.433,126,327,.385,192,408,.471,.518,89,138,.645,24,112,136,210,68,15,95,135,851
Andre Roberson,SG,26,OKC,39,39,1037,87,162,.537,8,36,.222,79,126,.627,.562,12,38,.316,75,110,185,46,45,35,30,89,194
Glenn Robinson,SF,24,IND,17,0,231,22,57,.386,5,18,.278,17,39,.436,.430,6,7,.857,8,17,25,12,11,1,2,11,55
Rajon Rondo,PG,31,NOP,58,56,1505,203,438,.463,45,132,.341,158,306,.516,.515,24,41,.585,28,203,231,459,60,10,128,106,475
Derrick Rose,PG,29,TOT,21,7,366,73,165,.442,6,27,.222,67,138,.486,.461,38,44,.864,13,20,33,34,5,4,32,15,190
Derrick Rose,PG,29,CLE,16,7,308,58,132,.439,6,24,.250,52,108,.481,.462,35,41,.854,10,19,29,26,3,4,28,14,157
Derrick Rose,PG,29,MIN,5,0,58,15,33,.455,0,3,.000,15,30,.500,.455,3,3,1.000,3,1,4,8,2,0,4,1,33
Terrence Ross,SG,26,ORL,22,20,576,72,177,.407,28,85,.329,44,92,.478,.486,26,35,.743,10,60,70,35,27,9,25,44,198
Terry Rozier,PG,23,BOS,75,11,1915,298,745,.400,147,378,.389,151,367,.411,.499,109,141,.773,59,287,346,203,77,15,70,117,852
Ricky Rubio,PG,27,UTA,71,71,2124,310,764,.406,83,249,.333,227,515,.441,.460,203,237,.857,39,284,323,385,114,10,199,195,906
D'Angelo Russell,PG,21,BRK,41,28,1070,244,586,.416,74,226,.327,170,360,.472,.480,96,128,.750,28,136,164,211,29,15,123,83,658
Domantas Sabonis,C,21,IND,68,19,1677,310,594,.522,12,33,.364,298,561,.531,.532,152,207,.734,154,381,535,141,33,28,129,200,784
JaKarr Sampson,SF,24,SAC,17,3,248,29,47,.617,5,8,.625,24,39,.615,.670,5,8,.625,13,42,55,8,7,14,6,38,68
Dario Saric,PF,23,PHI,73,68,2204,386,842,.458,150,374,.401,236,468,.504,.548,177,204,.868,149,354,503,190,49,20,141,153,1099
Tomas Satoransky,SG,26,WAS,66,27,1450,176,337,.522,43,92,.467,133,245,.543,.586,73,94,.777,61,138,199,259,49,13,73,118,468
Dennis Schroder,PG,24,ATL,67,67,2078,500,1146,.436,76,262,.290,424,884,.480,.469,225,265,.849,44,164,208,417,72,6,183,147,1301
Mike Scott,PF,29,WAS,69,1,1252,244,462,.528,58,143,.406,186,319,.583,.591,42,63,.667,42,176,218,69,22,10,74,134,588
Thabo Sefolosha,SF,33,UTA,38,6,806,118,240,.492,32,84,.381,86,156,.551,.558,44,54,.815,29,132,161,33,52,12,30,59,312
Wayne Selden,SG,23,MEM,33,8,638,107,248,.431,45,113,.398,62,135,.459,.522,41,55,.745,15,38,53,61,18,4,50,55,300
Ramon Sessions,PG,31,TOT,24,3,373,40,114,.351,8,26,.308,32,88,.364,.386,43,56,.768,6,31,37,71,14,2,30,29,131
Ramon Sessions,PG,31,NYK,13,3,167,17,53,.321,2,11,.182,15,42,.357,.340,12,15,.800,1,17,18,27,7,1,15,14,48
Ramon Sessions,PG,31,WAS,11,0,206,23,61,.377,6,15,.400,17,46,.370,.426,31,41,.756,5,14,19,44,7,1,15,15,83
Iman Shumpert,SG,27,CLE,14,6,276,22,58,.379,7,26,.269,15,32,.469,.440,11,15,.733,7,34,41,17,9,4,17,22,62
Pascal Siakam,PF,23,TOR,74,4,1522,235,458,.513,27,125,.216,208,333,.625,.543,53,82,.646,76,259,335,143,57,38,61,149,550
Ben Simmons,PG,21,PHI,73,73,2499,489,908,.539,0,11,.000,489,897,.545,.539,176,311,.566,135,448,583,587,124,61,253,191,1154
Jonathon Simmons,SG,28,ORL,69,50,2029,354,761,.465,69,204,.338,285,557,.512,.511,185,241,.768,61,178,239,171,58,16,146,175,962
Kobi Simmons,PG,20,MEM,25,5,450,55,130,.423,5,22,.227,50,108,.463,.442,16,16,1.000,10,28,38,42,14,5,29,43,131
Kyle Singler,SF,29,OKC,12,0,59,7,21,.333,2,5,.400,5,16,.313,.381,7,13,.538,1,9,10,2,1,0,3,4,23
Marcus Smart,SG,23,BOS,54,11,1614,189,515,.367,75,249,.301,114,266,.429,.440,97,133,.729,43,146,189,259,71,23,129,133,550
Dennis Smith,PG,20,DAL,64,64,1890,371,944,.393,100,317,.315,271,627,.432,.446,130,186,.699,46,193,239,318,63,16,178,138,972
Ish Smith,PG,29,DET,75,35,1898,351,735,.478,25,78,.321,326,657,.496,.495,80,114,.702,27,181,208,322,59,17,99,133,807
J.R. Smith,SG,32,CLE,73,61,2080,219,548,.400,132,358,.369,87,190,.458,.520,37,52,.712,28,188,216,133,65,11,74,152,607
Jason Smith,C,31,WAS,30,2,258,40,104,.385,4,29,.138,36,75,.480,.404,17,19,.895,17,31,48,14,3,11,15,41,101
Josh Smith,PF,32,NOP,3,0,12,1,4,.250,0,0,,1,4,.250,.250,0,0,,3,1,4,0,0,0,0,3,2
Tony Snell,SG,26,MIL,68,52,1876,170,384,.443,99,240,.413,71,144,.493,.572,37,46,.804,9,119,128,89,45,24,35,104,476
Marreese Speights,C,30,ORL,50,3,647,132,335,.394,84,227,.370,48,108,.444,.519,40,53,.755,20,109,129,37,6,22,37,102,388
Nik Stauskas,SG,24,TOT,35,0,428,46,120,.383,33,81,.407,13,39,.333,.521,17,22,.773,3,49,52,29,8,3,21,18,142
Nik Stauskas,SG,24,PHI,6,0,45,1,4,.250,0,1,.000,1,3,.333,.250,2,2,1.000,0,1,1,1,4,0,4,3,4
Nik Stauskas,SG,24,BRK,29,0,383,45,116,.388,33,80,.413,12,36,.333,.530,15,20,.750,3,48,51,28,4,3,17,15,138
Lance Stephenson,SG,27,IND,76,6,1706,287,656,.438,63,208,.303,224,448,.500,.486,76,112,.679,56,322,378,214,43,14,128,163,713
David Stockton,PG,26,UTA,1,0,3,0,0,,0,0,,0,0,,,2,2,1.000,0,0,0,0,0,0,1,1,2
Julyan Stone,SG,29,CHO,17,0,74,2,5,.400,2,5,.400,0,0,,.600,1,2,.500,0,20,20,13,2,1,4,11,7
Caleb Swanigan,PF,20,POR,21,3,148,17,46,.370,1,6,.167,16,40,.400,.380,8,13,.615,14,24,38,10,5,3,13,28,43
Jayson Tatum,SF,19,BOS,75,75,2288,368,773,.476,97,226,.429,271,547,.495,.539,196,238,.824,48,335,383,115,71,57,108,161,1029
Isaiah Taylor,PG,23,ATL,60,4,969,133,303,.439,17,61,.279,116,242,.479,.467,91,131,.695,19,62,81,168,30,10,67,100,374
Jeff Teague,PG,29,MIN,65,65,2147,321,726,.442,76,205,.371,245,521,.470,.494,181,216,.838,23,170,193,461,96,20,165,159,899
Mirza Teletovic,PF,32,MIL,10,0,159,25,57,.439,21,45,.467,4,12,.333,.623,0,0,,3,20,23,10,4,1,7,14,71
Garrett Temple,SG,31,SAC,65,35,1615,199,476,.418,89,227,.392,110,249,.442,.512,60,78,.769,22,130,152,124,57,27,79,135,547
Milos Teodosic,PG,30,LAC,45,36,1134,151,360,.419,88,232,.379,63,128,.492,.542,39,46,.848,16,110,126,209,23,5,97,103,429
Jason Terry,SG,40,MIL,44,4,696,53,132,.402,35,97,.361,18,35,.514,.534,8,9,.889,5,39,44,52,34,11,23,43,149
Daniel Theis,C,25,BOS,63,3,936,126,233,.541,18,58,.310,108,175,.617,.579,61,81,.753,90,184,274,56,30,48,56,157,331
Isaiah Thomas,PG,28,TOT,32,15,862,157,421,.373,55,188,.293,102,233,.438,.438,117,131,.893,17,50,67,153,15,3,95,58,486
Isaiah Thomas,PG,28,CLE,15,14,406,70,194,.361,22,87,.253,48,107,.449,.418,59,68,.868,7,24,31,68,9,2,41,25,221
Isaiah Thomas,PG,28,LAL,17,1,456,87,227,.383,33,101,.327,54,126,.429,.456,58,63,.921,10,26,36,85,6,1,54,33,265
Lance Thomas,PF,29,NYK,68,28,1261,92,240,.383,45,113,.398,47,127,.370,.477,41,49,.837,41,119,160,42,28,14,39,125,270
Klay Thompson,SG,27,GSW,66,66,2268,510,1041,.490,206,465,.443,304,576,.528,.589,76,91,.835,26,228,254,175,46,34,114,108,1302
Tristan Thompson,C,26,CLE,46,22,963,120,209,.574,0,0,,120,209,.574,.574,40,74,.541,110,200,310,28,16,16,33,96,280
Sindarius Thornwell,SG,23,LAC,66,15,1017,86,197,.437,18,53,.340,68,144,.472,.482,53,77,.688,28,95,123,51,43,22,44,108,243
Anthony Tolliver,PF,32,DET,72,7,1523,180,408,.441,131,318,.412,49,90,.544,.602,94,114,.825,42,166,208,80,26,19,52,125,585
Karl-Anthony Towns,C,22,MIN,76,76,2690,586,1076,.545,116,265,.438,470,811,.580,.599,324,380,.853,220,709,929,184,60,111,152,262,1612
P.J. Tucker,SF,32,HOU,75,27,2079,153,394,.388,100,271,.369,53,123,.431,.515,42,58,.724,85,329,414,68,75,23,67,190,448
Evan Turner,SF,29,POR,72,33,1830,230,522,.441,35,112,.313,195,410,.476,.474,85,101,.842,29,201,230,158,38,25,91,143,580
Myles Turner,C,21,IND,59,56,1693,288,591,.487,53,143,.371,235,448,.525,.532,154,199,.774,87,309,396,84,35,112,88,169,783
Ekpe Udoh,C,30,UTA,58,3,779,58,115,.504,0,1,.000,58,114,.509,.504,41,54,.759,64,79,143,51,42,72,20,98,157
Tyler Ulis,PG,22,PHO,65,38,1448,183,472,.388,34,123,.276,149,349,.427,.424,68,83,.819,20,88,108,259,62,6,107,110,468
Jonas Valanciunas,C,25,TOR,71,71,1595,355,623,.570,29,67,.433,326,556,.586,.593,162,201,.806,166,440,606,78,29,64,109,184,901
Denzel Valentine,SG,24,CHI,75,37,2058,297,712,.417,140,363,.386,157,349,.450,.515,38,51,.745,48,344,392,241,64,11,95,180,772
Fred VanVleet,PG,23,TOR,70,0,1414,217,505,.430,99,239,.414,118,266,.444,.528,79,95,.832,24,151,175,221,66,18,68,123,612
Rashad Vaughn,SG,21,TOT,28,0,212,23,56,.411,14,37,.378,9,19,.474,.536,4,6,.667,3,18,21,13,5,3,6,15,64
Rashad Vaughn,SG,21,MIL,22,0,173,21,50,.420,13,35,.371,8,15,.533,.550,4,6,.667,2,15,17,12,4,3,4,12,59
Rashad Vaughn,SG,21,BRK,1,0,4,0,0,,0,0,,0,0,,,0,0,,0,0,0,1,0,0,0,1,0
Rashad Vaughn,SG,21,ORL,5,0,35,2,6,.333,1,2,.500,1,4,.250,.417,0,0,,1,3,4,0,1,0,2,2,5
Noah Vonleh,PF,22,TOT,51,16,826,99,221,.448,18,59,.305,81,162,.500,.489,35,54,.648,67,228,295,32,17,16,28,66,251
Noah Vonleh,PF,22,POR,33,12,476,47,96,.490,2,6,.333,45,90,.500,.500,23,31,.742,35,132,167,13,6,11,15,42,119
Noah Vonleh,PF,22,CHI,18,4,350,52,125,.416,16,53,.302,36,72,.500,.480,12,23,.522,32,96,128,19,11,5,13,24,132
Nikola Vucevic,C,27,ORL,51,51,1536,373,767,.486,64,194,.330,309,573,.539,.528,67,83,.807,92,370,462,168,50,53,103,132,877
Dwyane Wade,SG,36,TOT,62,3,1424,279,624,.447,30,101,.297,249,523,.476,.471,129,178,.725,48,189,237,211,57,43,129,117,717
Dwyane Wade,SG,36,CLE,46,3,1069,198,435,.455,23,70,.329,175,365,.479,.482,94,134,.701,39,142,181,163,42,32,92,84,513
Dwyane Wade,SG,36,MIA,16,0,355,81,189,.429,7,31,.226,74,158,.468,.447,35,44,.795,9,47,56,48,15,11,37,33,204
Dion Waiters,SG,26,MIA,30,30,918,163,410,.398,52,170,.306,111,240,.463,.461,51,69,.739,8,69,77,113,23,9,70,61,429
Kemba Walker,PG,27,CHO,74,74,2574,566,1307,.433,224,571,.392,342,736,.465,.519,348,404,.861,29,208,237,420,89,23,163,97,1704
John Wall,PG,27,WAS,37,37,1269,252,604,.417,53,148,.358,199,456,.436,.461,159,221,.719,20,112,132,343,49,42,133,69,716
Tyrone Wallace,PG,23,LAC,23,13,628,83,186,.446,8,27,.296,75,159,.472,.468,52,66,.788,16,68,84,55,21,11,30,63,226
Taurean Waller-Prince,SF,23,ATL,75,75,2274,368,873,.422,158,408,.387,210,465,.452,.512,139,166,.837,46,317,363,183,77,41,171,152,1033
Derrick Walton,PG,22,MIA,15,0,142,8,24,.333,7,17,.412,1,7,.143,.479,6,6,1.000,2,14,16,15,6,3,2,6,29
Jameel Warney,PF,24,DAL,3,0,27,7,12,.583,0,0,,7,12,.583,.583,3,5,.600,4,5,9,0,0,0,1,2,17
T.J. Warren,SF,24,PHO,65,65,2142,529,1063,.498,20,90,.222,509,973,.523,.507,193,255,.757,125,208,333,85,65,41,85,149,1271
Travis Wear,SF,27,LAL,13,0,172,22,57,.386,16,41,.390,6,16,.375,.526,8,8,1.000,0,30,30,4,3,4,4,23,68
James Webb,SF,24,BRK,9,0,108,5,21,.238,4,17,.235,1,4,.250,.333,0,0,,7,15,22,4,1,0,3,10,14
Briante Weber,PG,25,TOT,18,0,237,19,43,.442,4,11,.364,15,32,.469,.488,8,10,.800,8,27,35,22,18,5,15,28,50
Briante Weber,PG,25,HOU,13,0,118,9,22,.409,4,9,.444,5,13,.385,.500,4,4,1.000,3,15,18,13,10,3,7,18,26
Briante Weber,PG,25,MEM,5,0,119,10,21,.476,0,2,.000,10,19,.526,.476,4,6,.667,5,12,17,9,8,2,8,10,24
David West,C,37,GSW,66,0,907,202,347,.582,3,8,.375,199,339,.587,.586,56,73,.767,58,163,221,122,41,71,74,107,463
Russell Westbrook,PG,29,OKC,74,74,2680,701,1554,.451,87,299,.291,614,1255,.489,.479,383,521,.735,132,587,719,746,134,18,351,183,1872
Andrew White,SF,24,ATL,13,0,180,22,58,.379,15,37,.405,7,21,.333,.509,1,4,.250,4,22,26,4,2,1,6,10,60
Derrick White,PG,23,SAS,17,0,139,16,33,.485,8,13,.615,8,20,.400,.606,14,20,.700,5,21,26,9,4,3,6,8,54
Okaro White,PF,25,MIA,6,4,80,7,16,.438,4,11,.364,3,5,.600,.563,2,3,.667,3,8,11,2,1,1,1,6,20
Isaiah Whitehead,PG,22,BRK,16,0,180,40,86,.465,7,18,.389,33,68,.485,.506,13,19,.684,4,22,26,20,8,2,24,23,100
Hassan Whiteside,C,28,MIA,48,48,1235,279,510,.547,2,2,1.000,277,508,.545,.549,118,170,.694,154,407,561,49,36,81,88,113,678
Andrew Wiggins,SF,22,MIN,76,76,2754,536,1206,.444,106,320,.331,430,886,.485,.488,194,301,.645,72,251,323,141,82,47,133,153,1372
Jacob Wiley,PF,23,BRK,5,0,33,1,4,.250,1,2,.500,0,2,.000,.375,1,2,.500,2,9,11,2,1,0,0,4,4
Damien Wilkins,SF,38,IND,19,1,152,13,39,.333,4,18,.222,9,21,.429,.385,3,4,.750,5,11,16,9,2,1,5,7,33
Alan Williams,PF,25,PHO,2,0,35,2,9,.222,0,0,,2,9,.222,.222,1,2,.500,3,7,10,3,2,1,3,7,5
C.J. Williams,SG,27,LAC,31,15,607,76,168,.452,22,70,.314,54,98,.551,.518,13,16,.813,11,35,46,30,28,13,19,58,187
Derrick Williams,PF,26,LAL,2,0,9,1,4,.250,0,2,.000,1,2,.500,.250,0,0,,0,1,1,0,0,0,0,0,2
Lou Williams,SG,31,LAC,74,19,2426,548,1255,.437,182,503,.362,366,752,.487,.509,403,459,.878,38,152,190,400,81,18,223,100,1681
Marvin Williams,PF,31,CHO,72,72,1867,230,510,.451,108,273,.396,122,237,.515,.557,94,115,.817,70,274,344,82,52,32,62,110,662
Matt Williams,SG,24,MIA,3,0,11,2,6,.333,1,5,.200,1,1,1.000,.417,0,0,,0,1,1,0,0,0,1,1,5
Troy Williams,SF,23,TOT,20,0,274,48,101,.475,9,35,.257,39,66,.591,.520,17,27,.630,20,39,59,14,19,4,17,32,122
Troy Williams,SF,23,HOU,4,0,17,2,9,.222,0,5,.000,2,4,.500,.222,1,3,.333,1,3,4,1,1,0,1,2,5
Troy Williams,SF,23,NYK,16,0,257,46,92,.500,9,30,.300,37,62,.597,.549,16,24,.667,19,36,55,13,18,4,16,30,117
D.J. Wilson,PF,21,MIL,21,0,69,8,14,.571,2,5,.400,6,9,.667,.643,1,2,.500,1,8,9,3,2,1,4,5,19
Jamil Wilson,SF,27,LAC,15,10,274,38,81,.469,27,63,.429,11,18,.611,.636,2,4,.500,3,29,32,10,5,8,8,34,105
Justise Winslow,SF,21,MIA,62,25,1505,180,426,.423,47,116,.405,133,310,.429,.478,59,92,.641,58,278,336,133,49,31,69,130,466
Jeff Withey,C,27,DAL,9,0,39,6,16,.375,2,10,.200,4,6,.667,.438,1,2,.500,1,9,10,0,0,3,2,3,15
Nate Wolters,PG,26,UTA,5,0,19,1,6,.167,0,0,,1,6,.167,.167,0,0,,1,1,2,1,0,0,0,1,2
Brandan Wright,PF,30,TOT,28,1,381,59,102,.578,0,0,,59,102,.578,.578,21,33,.636,33,62,95,13,13,26,8,32,139
Brandan Wright,PF,30,MEM,27,1,366,57,99,.576,0,0,,57,99,.576,.576,21,33,.636,32,61,93,13,13,25,8,29,135
Brandan Wright,PF,30,HOU,1,0,15,2,3,.667,0,0,,2,3,.667,.667,0,0,,1,1,2,0,0,1,0,3,4
Delon Wright,PG,25,TOR,62,4,1286,183,387,.473,51,135,.378,132,252,.524,.539,88,106,.830,43,128,171,178,65,31,71,70,505
Guerschon Yabusele,PF,22,BOS,29,2,175,18,43,.419,10,29,.345,8,14,.571,.535,8,13,.615,14,26,40,14,2,2,11,21,54
James Young,SG,22,PHI,6,0,61,5,14,.357,3,10,.300,2,4,.500,.464,4,6,.667,0,2,2,2,0,0,1,4,17
Joe Young,PG,25,IND,50,1,520,74,171,.433,22,60,.367,52,111,.468,.497,22,29,.759,11,50,61,36,14,1,25,36,192
Nick Young,SG,32,GSW,73,8,1235,188,448,.420,113,297,.380,75,151,.497,.546,49,58,.845,18,87,105,33,36,7,38,90,538
Thaddeus Young,PF,29,IND,76,76,2475,401,819,.490,58,178,.326,343,641,.535,.525,50,84,.595,167,310,477,144,128,35,101,166,910
Cody Zeller,C,25,CHO,33,0,627,85,156,.545,2,3,.667,83,153,.542,.551,61,85,.718,67,110,177,31,14,21,33,81,233
Tyler Zeller,C,28,TOT,59,33,958,164,301,.545,10,28,.357,154,273,.564,.561,50,72,.694,93,172,265,41,15,30,43,108,388
Tyler Zeller,C,28,BRK,42,33,703,125,229,.546,10,26,.385,115,203,.567,.568,40,60,.667,62,131,193,28,8,21,35,78,300
Tyler Zeller,C,28,MIL,17,0,255,39,72,.542,0,2,.000,39,70,.557,.542,10,12,.833,31,41,72,13,7,9,8,30,88
Paul Zipser,SF,23,CHI,54,12,824,81,234,.346,37,110,.336,44,124,.355,.425,19,26,.731,13,118,131,46,20,15,43,86,218
Ante Zizic,C,21,CLE,28,2,184,41,57,.719,0,0,,41,57,.719,.719,15,20,.750,22,31,53,5,1,13,10,26,97
Ivica Zubac,C,20,LAL,35,0,266,39,78,.500,0,0,,39,78,.500,.500,28,36,.778,26,50,76,13,5,8,20,32,106
