Player,Pos,Age,Tm,G,GS,MP,FG,FGA,FG%,3P,3PA,3P%,2P,2PA,2P%,eFG%,FT,FTA,FT%,ORB,DRB,TRB,AST,STL,BLK,TOV,PF,PTS
Alex Abrines,SG,25,OKC,31,2,588,56,157,.357,41,127,.323,15,30,.500,.487,12,13,.923,5,43,48,20,17,6,14,53,165
Quincy Acy,PF,28,PHO,10,0,123,4,18,.222,2,15,.133,2,3,.667,.278,7,10,.700,3,22,25,8,1,4,4,24,17
Jaylen Adams,PG,22,ATL,9,0,43,3,10,.300,2,6,.333,1,4,.250,.400,0,0,,0,3,3,6,3,1,1,4,8
Steven Adams,C,25,OKC,49,49,1666,317,522,.607,0,1,.000,317,521,.608,.607,116,208,.558,229,258,487,86,74,37,80,126,750
Bam Adebayo,C,21,MIA,51,6,1129,153,272,.563,1,9,.111,152,263,.578,.564,105,144,.729,104,238,342,102,37,40,71,131,412
Deng Adel,SF,21,CLE,7,0,68,5,11,.455,3,7,.429,2,4,.500,.591,2,2,1.000,2,6,8,2,1,2,3,6,15
DeVaughn Akoon-Purcell,SG,25,DEN,7,0,22,3,10,.300,0,4,.000,3,6,.500,.300,1,2,.500,1,3,4,6,2,0,2,4,7
LaMarcus Aldridge,C,33,SAS,54,54,1761,450,872,.516,4,19,.211,446,853,.523,.518,238,280,.850,166,316,482,140,29,64,103,116,1142
Rawle Alkins,SG,21,CHI,2,0,4,1,4,.250,1,1,1.000,0,3,.000,.375,0,0,,3,0,3,2,1,0,0,0,3
Grayson Allen,SG,23,UTA,26,1,270,33,105,.314,18,66,.273,15,39,.385,.400,25,34,.735,1,10,11,17,3,3,16,30,109
Jarrett Allen,C,20,BRK,52,52,1390,222,384,.578,5,32,.156,217,352,.616,.585,130,177,.734,132,319,451,80,32,78,71,116,579
Kadeem Allen,SG,26,NYK,3,1,71,7,17,.412,1,3,.333,6,14,.429,.441,8,8,1.000,2,9,11,11,1,0,2,9,23
Al-Farouq Aminu,PF,28,POR,52,52,1538,164,381,.430,68,194,.351,96,187,.513,.520,97,116,.836,81,339,420,64,48,21,41,102,493
Justin Anderson,SF,25,ATL,26,0,226,29,76,.382,8,37,.216,21,39,.538,.434,15,20,.750,11,30,41,11,11,7,13,25,81
Kyle Anderson,SF,25,MEM,43,40,1281,150,276,.543,9,34,.265,141,242,.583,.560,37,64,.578,48,203,251,128,54,37,58,112,346
Ryan Anderson,PF,30,PHO,15,8,278,19,60,.317,7,34,.206,12,26,.462,.375,11,14,.786,14,31,45,17,3,1,12,23,56
Ike Anigbogu,C,20,IND,3,0,6,0,3,.000,0,0,,0,3,.000,.000,0,0,,1,2,3,1,0,1,1,0,0
Giannis Antetokounmpo,PF,24,MIL,48,48,1591,468,820,.571,23,117,.197,445,703,.633,.585,317,442,.717,109,491,600,280,70,68,185,167,1276
Carmelo Anthony,PF,34,HOU,10,2,294,49,121,.405,21,64,.328,28,57,.491,.492,15,22,.682,9,45,54,5,4,7,8,32,134
OG Anunoby,SF,21,TOR,42,5,843,120,273,.440,46,139,.331,74,134,.552,.524,15,38,.395,32,90,122,29,26,10,27,86,301
Ryan Arcidiacono,PG,24,CHI,52,24,1303,103,243,.424,60,161,.373,43,82,.524,.547,45,50,.900,14,105,119,181,51,2,44,115,311
Trevor Ariza,SF,33,TOT,48,48,1697,197,516,.382,103,307,.336,94,209,.450,.482,86,107,.804,32,240,272,178,72,11,79,93,583
Trevor Ariza,SF,33,PHO,26,26,884,86,227,.379,50,139,.360,36,88,.409,.489,36,43,.837,16,129,145,87,38,8,39,44,258
Trevor Ariza,SF,33,WAS,22,22,813,111,289,.384,53,168,.315,58,121,.479,.476,50,64,.781,16,111,127,91,34,3,40,49,325
D.J. Augustin,PG,31,ORL,52,52,1458,194,419,.463,89,204,.436,105,215,.488,.569,135,155,.871,28,85,113,246,29,0,81,76,612
Deandre Ayton,C,20,PHO,48,47,1481,342,582,.588,0,2,.000,342,580,.590,.588,99,128,.773,154,353,507,98,38,47,86,135,783
Dwayne Bacon,SG,23,CHO,24,0,256,44,83,.530,13,24,.542,31,59,.525,.608,10,12,.833,3,36,39,17,3,1,12,27,111
Marvin Bagley,PF,19,SAC,38,1,907,192,372,.516,11,46,.239,181,326,.555,.531,96,144,.667,90,167,257,34,20,36,65,80,491
Ron Baker,SG,25,TOT,15,0,152,4,20,.200,1,13,.077,3,7,.429,.225,5,6,.833,1,10,11,15,6,1,5,18,14
Ron Baker,SG,25,NYK,11,0,107,4,16,.250,1,9,.111,3,7,.429,.281,5,6,.833,1,6,7,13,5,0,3,16,14
Ron Baker,SG,25,WAS,4,0,45,0,4,.000,0,4,.000,0,0,,.000,0,0,,0,4,4,2,1,1,2,2,0
Wade Baldwin,PG,22,POR,16,0,94,10,33,.303,2,9,.222,8,24,.333,.333,8,11,.727,2,13,15,12,1,2,14,11,30
Lonzo Ball,PG,21,LAL,47,45,1423,185,456,.406,75,228,.329,110,228,.482,.488,20,48,.417,54,197,251,255,69,19,103,114,465
Mohamed Bamba,C,20,ORL,47,1,766,117,243,.481,21,70,.300,96,173,.555,.525,37,63,.587,64,169,233,39,13,64,43,102,292
J.J. Barea,PG,34,DAL,38,0,752,161,385,.418,38,128,.297,123,257,.479,.468,55,78,.705,13,82,95,211,22,1,72,50,415
Harrison Barnes,PF,26,DAL,48,48,1558,286,704,.406,119,305,.390,167,399,.419,.491,165,198,.833,36,168,204,61,33,11,67,79,856
Will Barton,SG,28,DEN,13,8,327,62,138,.449,23,59,.390,39,79,.494,.533,22,28,.786,12,45,57,38,3,7,18,29,169
Keita Bates-Diop,SF,23,MIN,5,0,32,3,11,.273,0,5,.000,3,6,.500,.273,0,2,.000,0,6,6,0,0,1,1,2,6
Nicolas Batum,SF,30,CHO,52,52,1608,177,378,.468,76,187,.406,101,191,.529,.569,59,69,.855,46,225,271,171,49,27,84,93,489
Jerryd Bayless,PG,30,MIN,15,4,313,44,122,.361,22,59,.373,22,63,.349,.451,7,12,.583,6,28,34,61,9,1,17,24,117
Aron Baynes,C,32,BOS,34,10,507,69,148,.466,16,48,.333,53,100,.530,.520,39,46,.848,60,87,147,38,6,22,28,82,193
Kent Bazemore,SG,29,ATL,38,30,1011,186,422,.441,57,175,.326,129,247,.522,.508,87,116,.750,21,128,149,95,63,32,78,101,516
Bradley Beal,SG,25,WAS,52,52,1926,475,1013,.469,132,375,.352,343,638,.538,.534,203,255,.796,57,205,262,263,71,40,142,153,1285
Malik Beasley,SG,22,DEN,52,9,1215,228,451,.506,104,242,.430,124,209,.593,.621,33,38,.868,20,111,131,64,35,6,31,77,593
Michael Beasley,PF,30,LAL,25,2,265,75,145,.517,3,15,.200,72,130,.554,.528,28,39,.718,12,43,55,22,9,10,26,41,181
Marco Belinelli,SG,32,SAS,52,0,1165,195,457,.427,105,264,.398,90,193,.466,.542,82,90,.911,9,110,119,101,26,8,44,87,577
Jordan Bell,C,24,GSW,46,2,502,58,111,.523,0,1,.000,58,110,.527,.523,14,21,.667,34,81,115,55,15,35,23,54,130
DeAndre' Bembry,SG,24,ATL,52,15,1297,175,409,.428,36,123,.293,139,286,.486,.472,55,89,.618,30,189,219,139,68,29,95,130,441
Dragan Bender,PF,21,PHO,20,5,242,32,74,.432,7,38,.184,25,36,.694,.480,16,24,.667,15,35,50,13,5,3,14,20,87
Davis Bertans,PF,26,SAS,48,5,989,132,271,.487,98,208,.471,34,63,.540,.668,25,30,.833,17,148,165,60,25,22,29,81,387
Patrick Beverley,PG,30,LAC,53,24,1412,118,309,.382,70,187,.374,48,122,.393,.495,71,94,.755,45,200,245,186,39,28,56,181,377
Khem Birch,C,26,ORL,21,0,194,21,41,.512,0,1,.000,21,40,.525,.512,15,19,.789,16,38,54,12,7,11,4,19,57
Bismack Biyombo,C,26,CHO,27,15,417,48,85,.565,0,0,,48,85,.565,.565,29,45,.644,43,92,135,16,7,29,16,58,125
Nemanja Bjelica,PF,30,SAC,51,50,1207,192,399,.481,74,173,.428,118,226,.522,.574,48,63,.762,82,218,300,101,38,41,62,129,506
Antonio Blakeney,SG,22,CHI,40,0,578,120,284,.423,32,70,.457,88,214,.411,.479,38,56,.679,6,59,65,22,10,8,25,26,310
Eric Bledsoe,PG,29,MIL,50,50,1469,305,620,.492,73,240,.304,232,380,.611,.551,106,138,.768,50,177,227,274,74,20,106,105,789
Jaron Blossomgame,SF,25,CLE,25,4,407,44,95,.463,10,32,.313,34,63,.540,.516,10,13,.769,25,67,92,11,7,8,11,20,108
Bogdan Bogdanovic,SG,26,SAC,40,8,1119,222,520,.427,78,225,.347,144,295,.488,.502,81,99,.818,18,124,142,164,39,7,73,78,603
Bojan Bogdanovic,SF,29,IND,52,52,1651,303,618,.490,100,233,.429,203,385,.527,.571,144,173,.832,25,188,213,89,42,0,78,86,850
Jonah Bolden,PF,23,PHI,27,3,343,40,83,.482,14,46,.304,26,37,.703,.566,8,18,.444,24,72,96,16,8,24,23,57,102
Isaac Bonga,PG,19,LAL,8,0,31,2,10,.200,0,2,.000,2,8,.250,.200,4,7,.571,3,3,6,6,3,0,2,3,8
Devin Booker,SG,22,PHO,41,41,1428,363,787,.461,88,270,.326,275,517,.532,.517,211,249,.847,22,131,153,277,38,7,163,131,1025
Chris Boucher,PF,26,TOR,15,0,83,17,40,.425,9,22,.409,8,18,.444,.538,11,13,.846,9,15,24,0,2,16,2,14,54
Avery Bradley,SG,28,LAC,47,47,1402,157,409,.384,57,167,.341,100,242,.413,.454,19,23,.826,35,92,127,95,27,15,60,128,390
Tony Bradley,C,21,UTA,1,0,9,0,3,.000,0,0,,0,3,.000,.000,0,0,,2,1,3,0,0,0,1,1,0
Corey Brewer,SF,32,PHI,7,3,140,20,49,.408,4,14,.286,16,35,.457,.449,9,13,.692,4,13,17,10,12,2,8,16,53
Mikal Bridges,SF,22,PHO,54,40,1467,157,356,.441,75,205,.366,82,151,.543,.546,46,57,.807,31,132,163,88,80,29,40,126,435
Miles Bridges,SF,20,CHO,50,0,953,127,280,.454,35,114,.307,92,166,.554,.516,41,56,.732,29,152,181,52,24,30,29,64,330
Isaiah Briscoe,PG,22,ORL,28,0,317,31,82,.378,6,17,.353,25,65,.385,.415,8,17,.471,2,35,37,49,4,0,17,41,76
Ryan Broekhoff,SG,28,DAL,22,0,172,24,52,.462,15,40,.375,9,12,.750,.606,2,2,1.000,2,17,19,11,1,2,5,10,65
Malcolm Brogdon,SG,26,MIL,47,47,1385,279,544,.513,71,169,.420,208,375,.555,.578,106,112,.946,49,172,221,158,34,11,76,79,735
Dillon Brooks,SF,23,MEM,18,0,330,49,122,.402,15,40,.375,34,82,.415,.463,22,30,.733,9,22,31,16,10,4,19,50,135
MarShon Brooks,SG,30,MEM,29,0,387,76,169,.450,15,54,.278,61,115,.530,.494,23,33,.697,12,33,45,25,9,4,21,33,190
Bruce Brown,SG,22,DET,44,26,880,83,217,.382,17,63,.270,66,154,.429,.422,31,43,.721,32,96,128,61,21,21,33,114,214
Jaylen Brown,SG,22,BOS,47,22,1221,226,501,.451,56,175,.320,170,326,.521,.507,87,127,.685,45,158,203,64,43,25,67,123,595
Lorenzo Brown,PG,28,TOR,26,0,212,23,71,.324,6,28,.214,17,43,.395,.366,3,3,1.000,5,26,31,28,12,5,16,22,55
Sterling Brown,SG,23,MIL,40,0,637,86,187,.460,37,98,.378,49,89,.551,.559,15,19,.789,21,94,115,51,15,5,27,56,224
Troy Brown,SF,19,WAS,29,0,208,26,65,.400,4,15,.267,22,50,.440,.431,14,21,.667,5,34,39,27,8,1,8,16,70
Jalen Brunson,PG,22,DAL,44,12,760,115,265,.434,26,77,.338,89,188,.473,.483,38,55,.691,12,67,79,99,20,1,37,63,294
Thomas Bryant,C,21,WAS,42,36,801,159,244,.652,14,36,.389,145,208,.697,.680,57,70,.814,57,180,237,44,15,31,32,63,389
Reggie Bullock,SG,27,DET,42,42,1293,171,418,.409,106,277,.383,65,141,.461,.536,56,64,.875,19,93,112,103,20,5,52,76,504
Trey Burke,PG,26,NYK,33,7,689,148,358,.413,30,86,.349,118,272,.434,.455,62,75,.827,15,47,62,94,21,5,29,33,388
Alec Burks,SG,27,TOT,50,23,1211,174,435,.400,59,156,.378,115,279,.412,.468,111,135,.822,26,183,209,116,29,20,58,82,518
Alec Burks,SG,27,UTA,17,0,269,47,114,.412,16,43,.372,31,71,.437,.482,33,38,.868,2,25,27,20,6,4,15,22,143
Alec Burks,SG,27,CLE,33,23,942,127,321,.396,43,113,.381,84,208,.404,.463,78,97,.804,24,158,182,96,23,16,43,60,375
Deonte Burton,SG,25,OKC,15,0,131,20,46,.435,4,13,.308,16,33,.485,.478,5,6,.833,1,15,16,5,3,5,7,17,49
Jimmy Butler,SF-SG,29,TOT,41,41,1364,284,594,.478,54,143,.378,230,451,.510,.524,178,210,.848,70,135,205,158,86,25,61,75,800
Jimmy Butler,SG,29,MIN,10,10,361,74,157,.471,17,45,.378,57,112,.509,.525,48,61,.787,16,36,52,43,24,10,14,18,213
Jimmy Butler,SF,29,PHI,31,31,1003,210,437,.481,37,98,.378,173,339,.510,.523,130,149,.872,54,99,153,115,62,15,47,57,587
Bruno Caboclo,SF,23,MEM,5,0,115,8,29,.276,5,23,.217,3,6,.500,.362,9,9,1.000,5,12,17,5,3,8,3,10,30
Jose Calderon,PG,37,DET,42,0,598,42,115,.365,14,56,.250,28,59,.475,.426,9,11,.818,9,46,55,110,16,3,35,61,107
Kentavious Caldwell-Pope,SG,25,LAL,53,12,1269,186,431,.432,85,244,.348,101,187,.540,.530,91,106,.858,32,117,149,59,46,5,37,84,548
Isaiah Canaan,PG,27,TOT,21,15,520,52,135,.385,26,77,.338,26,58,.448,.481,15,20,.750,5,45,50,63,12,0,30,47,145
Isaiah Canaan,PG,27,PHO,19,15,503,51,129,.395,25,72,.347,26,57,.456,.492,15,20,.750,5,44,49,62,12,0,29,46,142
Isaiah Canaan,PG,27,MIN,2,0,17,1,6,.167,1,5,.200,0,1,.000,.250,0,0,,0,1,1,1,0,0,1,1,3
Clint Capela,C,24,HOU,42,42,1436,315,499,.631,0,0,,315,499,.631,.631,109,174,.626,208,320,528,62,25,77,65,112,739
DeMarre Carroll,SF,32,BRK,42,0,1054,143,364,.393,66,193,.342,77,171,.450,.484,113,153,.739,42,168,210,48,17,5,45,68,465
Jevon Carter,PG,23,MEM,19,3,298,23,87,.264,12,48,.250,11,39,.282,.333,5,9,.556,4,17,21,33,15,5,14,30,63
Vince Carter,SF,42,ATL,48,8,759,108,266,.406,66,178,.371,42,88,.477,.530,20,28,.714,22,105,127,46,27,15,32,82,302
Wendell Carter,C,19,CHI,44,44,1110,180,371,.485,6,32,.188,174,339,.513,.493,89,112,.795,87,220,307,78,26,58,65,152,455
Michael Carter-Williams,PG,27,HOU,16,1,145,25,61,.410,7,19,.368,18,42,.429,.467,12,26,.462,3,10,13,21,9,6,10,27,69
Alex Caruso,PG,24,LAL,5,0,20,2,4,.500,1,1,1.000,1,3,.333,.625,1,4,.250,1,0,1,1,0,2,0,3,6
Omri Casspi,SF,30,MEM,36,0,520,86,161,.534,15,43,.349,71,118,.602,.581,39,58,.672,17,98,115,26,20,9,23,35,226
Willie Cauley-Stein,C,25,SAC,52,52,1478,295,544,.542,1,2,.500,294,542,.542,.543,96,171,.561,128,325,453,139,64,31,66,160,687
Troy Caupain,PG,23,ORL,2,0,9,2,4,.500,1,2,.500,1,2,.500,.625,0,0,,0,2,2,3,1,0,0,0,5
Tyler Cavanaugh,PF,24,UTA,7,0,17,2,6,.333,0,3,.000,2,3,.667,.333,2,2,1.000,1,3,4,0,0,0,1,0,6
Tyson Chandler,C,36,TOT,45,6,780,59,97,.608,0,1,.000,59,96,.615,.608,48,79,.608,88,193,281,34,20,20,35,99,166
Tyson Chandler,C,36,PHO,7,0,89,8,12,.667,0,0,,8,12,.667,.667,10,18,.556,7,32,39,6,2,1,7,21,26
Tyson Chandler,C,36,LAL,38,6,691,51,85,.600,0,1,.000,51,84,.607,.600,38,61,.623,81,161,242,28,18,19,28,78,140
Wilson Chandler,PF,31,PHI,36,32,951,91,207,.440,46,118,.390,45,89,.506,.551,13,18,.722,44,124,168,72,22,18,39,94,241
Joe Chealey,PG,23,CHO,1,0,8,1,3,.333,0,0,,1,3,.333,.333,0,0,,0,0,0,1,0,0,0,1,2
Marquese Chriss,PF,21,HOU,16,0,104,11,34,.324,1,15,.067,10,19,.526,.338,6,7,.857,7,21,28,6,2,4,12,17,29
Gary Clark,PF,24,HOU,36,1,527,35,109,.321,29,99,.293,6,10,.600,.454,6,6,1.000,18,76,94,14,15,22,5,38,105
Ian Clark,SG,27,NOP,36,0,471,59,152,.388,27,77,.351,32,75,.427,.477,11,12,.917,5,43,48,43,7,4,28,46,156
Jordan Clarkson,SG,26,CLE,52,0,1376,345,756,.456,94,276,.341,251,480,.523,.519,90,109,.826,48,123,171,121,37,10,86,81,874
John Collins,PF,21,ATL,36,34,1081,285,486,.586,34,92,.370,251,394,.637,.621,106,145,.731,136,222,358,79,11,14,78,120,710
Zach Collins,C,21,POR,52,0,969,137,286,.479,30,86,.349,107,200,.535,.531,67,84,.798,74,151,225,52,19,42,53,135,371
Darren Collison,PG,31,IND,52,52,1444,192,417,.460,53,128,.414,139,289,.481,.524,88,107,.822,22,126,148,302,76,8,82,94,525
Mike Conley,PG,31,MEM,51,51,1722,351,810,.433,110,306,.359,241,504,.478,.501,217,257,.844,29,142,171,321,70,17,97,88,1029
Pat Connaughton,SG,26,MIL,32,1,572,76,175,.434,30,104,.288,46,71,.648,.520,14,20,.700,26,89,115,67,15,15,17,37,196
Quinn Cook,PG,25,GSW,44,8,649,128,276,.464,49,123,.398,79,153,.516,.553,15,20,.750,14,84,98,75,15,3,32,62,320
DeMarcus Cousins,C,28,GSW,7,7,159,34,78,.436,7,18,.389,27,60,.450,.481,26,32,.813,7,44,51,28,7,6,13,28,101
Robert Covington,SF,28,TOT,35,35,1203,156,362,.431,85,225,.378,71,137,.518,.548,68,89,.764,28,165,193,46,74,47,47,126,465
Robert Covington,SF,28,PHI,13,13,440,50,117,.427,30,77,.390,20,40,.500,.556,17,23,.739,7,60,67,14,24,23,22,45,147
Robert Covington,SF,28,MIN,22,22,763,106,245,.433,55,148,.372,51,97,.526,.545,51,66,.773,21,105,126,32,50,24,25,81,318
Allen Crabbe,SG,26,BRK,28,15,732,85,248,.343,65,168,.387,20,80,.250,.474,30,38,.789,13,84,97,30,17,8,32,68,265
Torrey Craig,SF,28,DEN,47,37,1079,115,259,.444,38,129,.295,77,130,.592,.517,32,50,.640,70,126,196,48,27,30,38,117,300
Jamal Crawford,SG,38,PHO,44,0,782,99,272,.364,33,115,.287,66,157,.420,.425,55,68,.809,7,44,51,147,20,8,63,55,286
Mitch Creek,SF,26,BRK,3,0,20,2,5,.400,0,0,,2,5,.400,.400,3,4,.750,1,4,5,1,1,0,0,2,7
Jae Crowder,SF,28,UTA,53,8,1463,209,529,.395,115,346,.332,94,183,.514,.504,102,146,.699,41,208,249,87,42,21,62,108,635
Dante Cunningham,PF,31,SAS,48,21,769,62,131,.473,27,55,.491,35,76,.461,.576,11,14,.786,43,124,167,45,21,13,18,61,162
Seth Curry,SG,28,POR,46,2,820,109,245,.445,65,134,.485,44,111,.396,.578,9,9,1.000,15,54,69,45,18,7,34,65,292
Stephen Curry,PG,30,GSW,41,41,1406,400,811,.493,215,477,.451,185,334,.554,.626,181,196,.923,29,179,208,218,47,14,118,104,1196
Troy Daniels,SG,27,PHO,27,0,356,52,128,.406,38,97,.392,14,31,.452,.555,12,15,.800,6,23,29,9,16,2,17,35,154
Anthony Davis,C,25,NOP,41,41,1519,430,846,.508,40,123,.325,390,723,.539,.532,303,373,.812,138,407,545,179,70,105,82,107,1203
Ed Davis,C,29,BRK,53,1,980,131,210,.624,0,2,.000,131,208,.630,.624,58,101,.574,157,315,472,45,27,20,44,151,320
Tyler Davis,C,21,OKC,1,0,1,0,1,.000,0,0,,0,1,.000,.000,0,0,,1,0,1,0,0,0,0,0,0
Dewayne Dedmon,C,29,ATL,42,31,1042,163,339,.481,52,137,.380,111,202,.550,.558,55,63,.873,67,242,309,58,44,44,60,141,433
Sam Dekker,SF-PF,24,TOT,33,5,572,94,189,.497,11,38,.289,83,151,.550,.526,18,30,.600,41,78,119,31,31,7,15,32,217
Sam Dekker,PF,24,CLE,9,5,169,22,48,.458,5,13,.385,17,35,.486,.510,8,10,.800,9,24,33,9,11,0,5,13,57
Sam Dekker,SF,24,WAS,24,0,403,72,141,.511,6,25,.240,66,116,.569,.532,10,20,.500,32,54,86,22,20,7,10,19,160
Matthew Dellavedova,PG,28,TOT,36,0,552,75,169,.444,36,93,.387,39,76,.513,.550,32,37,.865,5,47,52,115,6,0,49,52,218
Matthew Dellavedova,PG,28,MIL,12,0,97,6,19,.316,4,11,.364,2,8,.250,.421,4,4,1.000,0,10,10,29,2,0,11,9,20
Matthew Dellavedova,PG,28,CLE,24,0,455,69,150,.460,32,82,.390,37,68,.544,.567,28,33,.848,5,37,42,86,4,0,38,43,198
Luol Deng,SF,33,MIN,13,0,168,27,57,.474,8,24,.333,19,33,.576,.544,15,19,.789,10,25,35,5,7,2,5,9,77
DeMar DeRozan,SG,29,SAS,50,50,1762,408,885,.461,7,41,.171,401,844,.475,.465,238,289,.824,39,274,313,311,51,25,131,112,1061
Marcus Derrickson,PF,22,GSW,8,0,45,8,20,.400,3,11,.273,5,9,.556,.475,3,4,.750,3,3,6,0,0,1,3,9,22
Cheick Diallo,PF,22,NOP,35,0,361,59,102,.578,0,2,.000,59,100,.590,.578,23,33,.697,29,94,123,13,14,17,22,43,141
Hamidou Diallo,SG,20,OKC,42,3,502,72,158,.456,4,23,.174,68,135,.504,.468,35,58,.603,36,56,92,17,18,10,21,73,183
Gorgui Dieng,C,29,MIN,52,0,710,110,224,.491,13,39,.333,97,185,.524,.520,55,62,.887,50,160,210,45,26,27,32,101,288
Spencer Dinwiddie,PG,25,BRK,49,4,1399,275,596,.461,96,262,.366,179,334,.536,.542,198,249,.795,21,100,121,246,28,11,114,136,844
Donte DiVincenzo,SG,22,MIL,23,0,358,42,107,.393,17,69,.246,25,38,.658,.472,9,11,.818,13,43,56,27,12,6,18,34,110
Luka Doncic,SG,19,DAL,50,50,1604,344,790,.435,120,341,.352,224,449,.499,.511,226,309,.731,54,297,351,271,56,14,159,94,1034
Tyler Dorsey,SG,22,ATL,27,0,251,32,89,.360,10,39,.256,22,50,.440,.416,16,26,.615,9,34,43,17,7,1,10,20,90
Damyean Dotson,SG,24,NYK,42,11,1055,151,344,.439,61,159,.384,90,185,.486,.528,34,49,.694,24,124,148,55,38,5,30,77,397
PJ Dozier,SG,22,BOS,4,0,10,3,6,.500,1,2,.500,2,4,.500,.583,0,0,,2,2,4,0,0,0,0,1,7
Goran Dragic,PG,32,MIA,14,14,408,77,188,.410,22,70,.314,55,118,.466,.468,38,50,.760,8,35,43,68,10,4,35,30,214
Andre Drummond,C,25,DET,48,48,1582,335,659,.508,4,31,.129,331,628,.527,.511,123,229,.537,250,463,713,57,76,79,116,162,797
Jared Dudley,PF,33,BRK,43,25,944,77,190,.405,39,121,.322,38,69,.551,.508,22,35,.629,25,95,120,65,28,13,37,105,215
Kris Dunn,PG,24,CHI,27,25,837,135,311,.434,16,45,.356,119,266,.447,.460,37,47,.787,7,107,114,169,40,14,68,101,323
Kevin Durant,PF,30,GSW,52,52,1847,500,990,.505,96,262,.366,404,728,.555,.554,334,368,.908,27,343,370,311,43,58,168,101,1430
Vince Edwards,SF,22,HOU,2,0,16,1,4,.250,1,4,.250,0,0,,.375,0,0,,1,1,2,0,0,0,0,0,3
Henry Ellenson,PF,22,DET,2,0,25,4,10,.400,2,4,.500,2,6,.333,.500,2,2,1.000,0,9,9,1,0,0,0,2,12
Wayne Ellington,SG,31,MIA,25,12,533,69,184,.375,57,155,.368,12,29,.414,.530,14,16,.875,6,41,47,29,24,3,14,40,209
Joel Embiid,C,24,PHI,49,49,1642,441,914,.482,57,194,.294,384,720,.533,.514,396,493,.803,125,536,661,176,29,95,177,163,1335
James Ennis,SF,28,HOU,38,24,886,98,195,.503,41,110,.373,57,85,.671,.608,40,56,.714,36,73,109,24,33,15,23,105,277
Drew Eubanks,PF,21,SAS,12,0,47,10,14,.714,0,0,,10,14,.714,.714,6,8,.750,1,11,12,2,1,0,2,4,26
Jacob Evans,SG,21,GSW,23,0,99,6,25,.240,1,6,.167,5,19,.263,.260,0,1,.000,1,8,9,13,1,1,6,13,13
Jawun Evans,PG,22,PHO,5,0,50,2,10,.200,0,2,.000,2,8,.250,.200,0,0,,1,9,10,9,3,0,4,7,4
Tyreke Evans,SG,29,IND,45,12,923,172,442,.389,54,153,.353,118,289,.408,.450,80,104,.769,25,98,123,106,46,11,80,76,478
Dante Exum,PG,23,UTA,39,1,637,101,234,.432,18,59,.305,83,175,.474,.470,68,86,.791,15,50,65,107,14,5,46,63,288
Kenneth Faried,C,29,TOT,19,6,323,71,119,.597,2,10,.200,69,109,.633,.605,32,52,.615,40,71,111,9,8,12,17,35,176
Kenneth Faried,C,29,BRK,12,0,118,25,42,.595,1,5,.200,24,37,.649,.607,10,16,.625,15,29,44,2,2,4,6,8,61
Kenneth Faried,C,29,HOU,7,6,205,46,77,.597,1,5,.200,45,72,.625,.604,22,36,.611,25,42,67,7,6,8,11,27,115
Derrick Favors,C,27,UTA,53,47,1225,231,401,.576,14,60,.233,217,341,.636,.594,103,158,.652,144,231,375,56,38,69,55,114,579
Cristiano Felicio,C,26,CHI,32,0,307,37,65,.569,0,2,.000,37,63,.587,.569,17,23,.739,25,59,84,16,5,2,14,27,91
Raymond Felton,PG,34,OKC,15,0,166,28,76,.368,6,30,.200,22,46,.478,.408,8,9,.889,3,18,21,27,6,4,11,13,70
Terrance Ferguson,SG,20,OKC,43,43,1006,100,230,.435,56,144,.389,44,86,.512,.557,16,25,.640,21,58,79,31,24,11,24,127,272
Yogi Ferrell,PG,25,SAC,42,3,617,91,207,.440,30,82,.366,61,125,.488,.512,31,35,.886,9,60,69,81,20,4,19,33,243
Dorian Finney-Smith,SF,25,DAL,52,13,1281,148,321,.461,54,156,.346,94,165,.570,.545,48,72,.667,90,148,238,39,52,26,50,124,398
Bryn Forbes,PG,25,SAS,54,54,1549,244,542,.450,118,279,.423,126,263,.479,.559,49,55,.891,10,145,155,120,32,3,60,118,655
Evan Fournier,SG,26,ORL,52,52,1628,292,683,.428,100,300,.333,192,383,.501,.501,82,106,.774,25,130,155,184,46,8,106,147,766
De'Aaron Fox,PG,21,SAC,51,51,1607,318,691,.460,55,151,.364,263,540,.487,.500,200,273,.733,31,156,187,367,88,26,156,133,891
Melvin Frazier,SG,22,ORL,3,0,16,0,3,.000,0,1,.000,0,2,.000,.000,0,0,,0,1,1,0,1,0,1,3,0
Tim Frazier,PG,28,NOP,41,17,776,75,168,.446,24,69,.348,51,99,.515,.518,24,31,.774,27,91,118,180,21,4,51,82,198
Channing Frye,C,35,CLE,26,5,268,30,87,.345,22,58,.379,8,29,.276,.471,9,12,.750,4,37,41,16,5,4,10,34,91
Markelle Fultz,PG,20,PHI,19,15,427,65,155,.419,4,14,.286,61,141,.433,.432,21,37,.568,26,44,70,59,17,5,25,52,155
Danilo Gallinari,SF,30,LAC,44,44,1377,254,565,.450,107,240,.446,147,325,.452,.544,221,244,.906,40,222,262,110,32,12,62,92,836
Langston Galloway,SG,27,DET,49,2,1061,135,358,.377,78,235,.332,57,123,.463,.486,43,54,.796,33,84,117,52,21,5,16,80,391
Marc Gasol,C,34,MEM,52,52,1757,292,664,.440,75,217,.346,217,447,.485,.496,151,200,.755,54,392,446,243,59,63,118,145,810
Pau Gasol,C,38,SAS,23,6,306,39,81,.481,5,10,.500,34,71,.479,.512,23,32,.719,20,97,117,46,4,13,14,24,106
Rudy Gay,PF,32,SAS,44,41,1199,252,482,.523,46,111,.414,206,371,.555,.571,78,90,.867,42,245,287,111,40,26,72,116,628
Paul George,SF,28,OKC,50,50,1801,464,1023,.454,184,449,.410,280,574,.488,.543,270,326,.828,75,326,401,202,116,24,129,137,1382
Taj Gibson,PF,33,MIN,51,51,1301,221,391,.565,11,33,.333,210,358,.587,.579,85,116,.733,130,214,344,63,43,30,56,136,538
Harry Giles,PF,20,SAC,39,0,496,102,205,.498,0,5,.000,102,200,.510,.498,28,50,.560,38,94,132,55,24,14,45,97,232
Shai Gilgeous-Alexander,PG,20,LAC,53,44,1385,203,439,.462,27,84,.321,176,355,.496,.493,96,118,.814,36,108,144,157,57,29,93,110,529
Rudy Gobert,C,26,UTA,54,53,1701,303,466,.650,0,0,,303,466,.650,.650,210,322,.652,202,490,692,118,49,117,84,153,816
Brandon Goodwin,PG,23,DEN,15,0,52,5,18,.278,2,4,.500,3,14,.214,.333,9,11,.818,1,2,3,12,0,0,3,7,21
Aaron Gordon,PF,23,ORL,49,49,1653,293,652,.449,76,218,.349,217,434,.500,.508,112,155,.723,86,280,366,169,35,33,92,109,774
Eric Gordon,SG,30,HOU,41,27,1339,231,593,.390,109,343,.318,122,250,.488,.481,91,116,.784,14,94,108,83,22,15,63,94,662
Marcin Gortat,C,34,LAC,46,42,738,99,185,.535,0,0,,99,185,.535,.535,35,48,.729,67,187,254,64,6,24,50,90,233
Devonte' Graham,PG,23,CHO,28,3,359,43,115,.374,21,64,.328,22,51,.431,.465,15,20,.750,2,28,30,61,16,0,18,28,122
Treveon Graham,SG,25,BRK,16,10,365,25,84,.298,11,50,.220,14,34,.412,.363,12,16,.750,13,37,50,17,6,4,14,38,73
Jerami Grant,PF,24,OKC,51,48,1641,249,486,.512,56,157,.357,193,329,.587,.570,103,147,.701,51,204,255,50,46,70,43,136,657
Jerian Grant,PG,26,ORL,44,1,776,67,171,.392,27,83,.325,40,88,.455,.471,21,31,.677,16,65,81,129,37,4,44,65,182
Danny Green,SG,31,TOR,51,51,1478,184,417,.441,118,280,.421,66,137,.482,.583,23,26,.885,45,169,214,66,46,42,50,121,509
Draymond Green,PF,28,GSW,37,37,1156,99,241,.411,22,89,.247,77,152,.507,.456,36,49,.735,39,251,290,273,61,38,94,122,256
Gerald Green,SG,33,HOU,48,0,1017,154,377,.408,105,298,.352,49,79,.620,.548,34,42,.810,23,107,130,29,16,19,35,92,447
JaMychal Green,PF,28,MEM,40,4,890,151,310,.487,38,96,.396,113,214,.528,.548,63,80,.788,71,176,247,36,33,26,64,123,403
Jeff Green,PF,32,WAS,50,25,1383,214,452,.473,74,199,.372,140,253,.553,.555,107,120,.892,46,180,226,92,26,25,63,109,609
Blake Griffin,PF,29,DET,49,49,1791,436,922,.473,120,335,.358,316,587,.538,.538,291,383,.760,64,337,401,262,39,21,185,141,1283
Daniel Hamilton,SG,23,ATL,19,3,204,23,60,.383,8,23,.348,15,37,.405,.450,3,6,.500,10,37,47,22,6,1,16,19,57
Tim Hardaway,SG,26,NYK,46,46,1499,282,726,.388,117,337,.347,165,389,.424,.469,199,233,.854,26,135,161,122,42,6,81,106,880
James Harden,SG,29,HOU,49,49,1837,518,1179,.439,241,652,.370,277,527,.526,.542,504,581,.867,48,283,331,396,106,39,269,164,1781
Maurice Harkless,SF,25,POR,32,25,693,81,173,.468,18,60,.300,63,113,.558,.520,18,26,.692,34,91,125,26,29,28,21,92,198
Montrezl Harrell,C,25,LAC,53,2,1384,334,536,.623,1,8,.125,333,528,.631,.624,166,272,.610,129,228,357,87,49,71,75,160,835
Devin Harris,PG,35,DAL,40,0,603,86,206,.417,35,114,.307,51,92,.554,.502,50,68,.735,6,55,61,54,26,8,29,71,257
Gary Harris,SG,24,DEN,32,27,956,174,409,.425,50,159,.314,124,250,.496,.487,75,92,.815,22,75,97,87,31,14,39,68,473
Joe Harris,SG,27,BRK,50,50,1484,242,496,.488,115,254,.453,127,242,.525,.604,64,76,.842,35,149,184,127,27,9,80,133,663
Tobias Harris,PF,26,LAC,53,53,1836,406,816,.498,106,249,.426,300,567,.529,.563,187,213,.878,35,386,421,143,39,24,100,117,1105
Andrew Harrison,SG-PG,24,TOT,17,0,187,16,53,.302,5,25,.200,11,28,.393,.349,17,18,.944,6,14,20,24,4,2,12,34,54
Andrew Harrison,PG,24,MEM,1,0,5,1,2,.500,0,1,.000,1,1,1.000,.500,0,0,,0,0,0,0,0,0,0,1,2
Andrew Harrison,SG,24,CLE,10,0,144,12,39,.308,3,14,.214,9,25,.360,.346,16,16,1.000,4,11,15,17,4,2,10,26,43
Andrew Harrison,SG,24,NOP,6,0,38,3,12,.250,2,10,.200,1,2,.500,.333,1,2,.500,2,3,5,7,0,0,2,7,9
Shaquille Harrison,PG,25,CHI,44,0,767,89,222,.401,16,58,.276,73,164,.445,.437,46,74,.622,15,100,115,71,51,16,32,71,240
Josh Hart,SG,23,LAL,53,21,1417,164,401,.409,81,238,.340,83,163,.509,.510,49,72,.681,29,183,212,80,56,34,53,122,458
Isaiah Hartenstein,PF,20,HOU,25,0,201,19,40,.475,2,6,.333,17,34,.500,.500,11,14,.786,21,22,43,13,6,10,13,51,51
Udonis Haslem,C,38,MIA,3,0,14,2,6,.333,0,2,.000,2,4,.500,.333,0,0,,1,4,5,0,0,0,2,3,4
Gordon Hayward,PF,28,BOS,47,16,1209,179,424,.422,55,172,.320,124,252,.492,.487,92,109,.844,40,175,215,159,46,15,69,66,505
John Henson,C,28,MIL,14,0,188,31,67,.463,11,31,.355,20,36,.556,.545,6,10,.600,16,55,71,14,7,11,12,16,79
Juan Hernangomez,PF,23,DEN,50,25,1166,129,276,.467,63,158,.399,66,118,.559,.582,62,78,.795,59,178,237,45,22,22,33,70,383
Willy Hernangomez,C,24,CHO,44,2,607,120,231,.519,13,30,.433,107,201,.532,.548,71,105,.676,90,154,244,40,11,15,45,79,324
Mario Hezonja,SF,23,NYK,43,11,814,127,317,.401,29,108,.269,98,209,.469,.446,50,71,.704,17,130,147,43,41,6,50,73,333
Buddy Hield,SG,26,SAC,52,52,1640,398,830,.480,180,391,.460,218,439,.497,.588,88,102,.863,64,192,256,121,27,18,95,128,1064
Haywood Highsmith,SF,22,PHI,2,0,9,1,2,.500,1,2,.500,0,0,,.750,0,0,,0,1,1,2,0,0,0,0,3
Nene Hilario,C,36,HOU,25,2,333,38,70,.543,0,2,.000,38,68,.559,.543,22,31,.710,19,61,80,18,9,9,6,53,98
George Hill,PG,32,TOT,39,13,898,111,246,.451,32,95,.337,79,151,.523,.516,42,52,.808,26,68,94,92,38,4,35,77,296
George Hill,PG,32,CLE,13,13,344,55,107,.514,13,28,.464,42,79,.532,.575,17,20,.850,12,15,27,36,12,1,20,35,140
George Hill,PG,32,MIL,26,0,554,56,139,.403,19,67,.284,37,72,.514,.471,25,32,.781,14,53,67,56,26,3,15,42,156
Solomon Hill,SF,27,NOP,34,15,706,50,129,.388,20,70,.286,30,59,.508,.465,17,25,.680,29,78,107,44,18,8,23,61,137
Aaron Holiday,PG,22,IND,33,0,367,61,159,.384,24,82,.293,37,77,.481,.459,27,30,.900,3,44,47,47,13,11,22,40,173
Jrue Holiday,SG,28,NOP,53,53,1943,432,906,.477,89,269,.331,343,637,.538,.526,162,214,.757,64,198,262,422,85,44,173,124,1115
Justin Holiday,SG,29,TOT,53,48,1728,186,507,.367,111,327,.339,75,180,.417,.476,59,66,.894,24,193,217,107,84,25,71,104,542
Justin Holiday,SG,29,CHI,38,38,1325,151,394,.383,97,270,.359,54,124,.435,.506,41,46,.891,19,150,169,85,67,21,47,79,440
Justin Holiday,SG,29,MEM,15,10,403,35,113,.310,14,57,.246,21,56,.375,.372,18,20,.900,5,43,48,22,17,4,24,25,102
John Holland,SF,30,CLE,1,0,1,0,0,,0,0,,0,0,,,0,0,,0,0,0,0,0,0,0,0,0
Rondae Hollis-Jefferson,SF,24,BRK,43,20,968,149,372,.401,9,39,.231,140,333,.420,.413,95,146,.651,58,178,236,76,32,22,49,82,402
Richaun Holmes,C,25,PHO,48,2,792,154,232,.664,0,0,,154,232,.664,.664,78,108,.722,77,140,217,41,30,59,37,125,386
Rodney Hood,SG,26,CLE,45,45,1234,194,454,.427,55,152,.362,139,302,.460,.488,104,114,.912,18,94,112,92,38,5,36,101,547
Al Horford,C,32,BOS,42,42,1186,223,419,.532,46,128,.359,177,291,.608,.587,35,45,.778,79,203,282,154,33,63,69,78,527
Danuel House,SF,25,HOU,25,12,620,71,155,.458,39,100,.390,32,55,.582,.584,45,55,.818,20,69,89,26,14,10,23,45,226
Dwight Howard,C,33,WAS,9,9,230,43,69,.623,0,0,,43,69,.623,.623,29,48,.604,24,59,83,4,7,4,16,34,115
Kevin Huerter,SG,20,ATL,48,32,1302,163,398,.410,84,220,.382,79,178,.444,.515,29,39,.744,40,115,155,134,42,19,76,94,439
Chandler Hutchison,SF,22,CHI,44,14,895,96,209,.459,14,50,.280,82,159,.516,.493,23,38,.605,31,154,185,34,23,6,25,59,229
Serge Ibaka,C,29,TOR,49,40,1423,327,626,.522,33,127,.260,294,499,.589,.549,100,127,.787,101,273,374,69,25,67,89,152,787
Andre Iguodala,SF,35,GSW,47,11,1108,102,210,.486,35,99,.354,67,111,.604,.569,33,53,.623,34,145,179,151,41,38,36,62,272
Ersan Ilyasova,PF,31,MIL,39,3,674,89,210,.424,30,88,.341,59,122,.484,.495,28,32,.875,48,122,170,36,24,9,30,91,236
Joe Ingles,SF,31,UTA,54,54,1684,229,531,.431,110,304,.362,119,227,.524,.535,67,93,.720,17,190,207,264,74,12,120,129,635
Brandon Ingram,SF,21,LAL,42,42,1401,280,575,.487,21,72,.292,259,503,.515,.505,141,217,.650,32,172,204,126,25,26,106,114,722
Kyrie Irving,PG,26,BOS,44,44,1439,396,796,.497,115,279,.412,281,517,.544,.570,133,156,.853,53,163,216,304,76,20,120,101,1040
Jonathan Isaac,PF,21,ORL,47,36,1207,139,341,.408,36,132,.273,103,209,.493,.460,75,89,.843,56,195,251,50,38,55,51,95,389
Wesley Iwundu,SF,24,ORL,39,12,654,63,159,.396,13,40,.325,50,119,.420,.437,47,58,.810,17,71,88,31,16,10,24,70,186
Demetrius Jackson,PG,24,PHI,6,0,39,8,15,.533,2,6,.333,6,9,.667,.600,4,4,1.000,2,1,3,5,2,0,1,4,22
Frank Jackson,PG,20,NOP,38,3,557,89,198,.449,25,77,.325,64,121,.529,.513,29,37,.784,9,48,57,33,11,0,24,53,232
Jaren Jackson,PF,19,MEM,52,50,1339,264,516,.512,40,121,.331,224,395,.567,.550,129,165,.782,64,178,242,58,47,77,86,199,697
Josh Jackson,SG,21,PHO,54,17,1270,214,523,.409,41,138,.297,173,385,.449,.448,92,140,.657,41,187,228,122,52,36,123,139,561
Justin Jackson,SF,23,SAC,51,3,1075,125,293,.427,55,158,.348,70,135,.519,.520,41,50,.820,25,120,145,68,23,13,22,67,346
Reggie Jackson,PG,28,DET,51,51,1486,258,636,.406,101,290,.348,157,346,.454,.485,130,150,.867,33,114,147,221,36,6,88,146,747
LeBron James,PF,34,LAL,35,35,1219,349,678,.515,69,197,.350,280,481,.582,.566,185,271,.683,33,264,297,252,45,24,120,54,952
Amile Jefferson,PF,25,ORL,1,0,4,0,1,.000,0,0,,0,1,.000,.000,2,2,1.000,1,0,1,0,0,0,0,1,2
Jonas Jerebko,PF,31,GSW,48,6,896,119,253,.470,50,138,.362,69,115,.600,.569,47,57,.825,57,174,231,73,16,9,35,102,335
Alize Johnson,PF,22,IND,11,0,32,2,10,.200,1,2,.500,1,8,.125,.250,1,4,.250,1,7,8,0,0,1,0,3,6
Amir Johnson,C,31,PHI,37,2,354,55,103,.534,9,24,.375,46,79,.582,.578,23,30,.767,26,69,95,45,11,8,33,72,142
James Johnson,PF,31,MIA,35,33,727,103,247,.417,32,94,.340,71,153,.464,.482,27,36,.750,16,92,108,82,20,13,44,70,265
Stanley Johnson,SF,22,DET,46,7,910,125,335,.373,46,174,.264,79,161,.491,.442,38,48,.792,24,141,165,56,46,12,55,86,334
Tyler Johnson,PG,26,MIA,43,9,1094,169,394,.429,72,200,.360,97,194,.500,.520,61,88,.693,19,100,119,110,40,20,62,71,471
Wesley Johnson,SF,31,NOP,26,13,377,35,88,.398,19,50,.380,16,38,.421,.506,6,9,.667,10,44,54,16,12,7,12,45,95
Nikola Jokic,C,23,DEN,51,51,1600,390,767,.508,57,185,.308,333,582,.572,.546,194,229,.847,148,390,538,394,71,35,159,145,1031
Damian Jones,C,23,GSW,24,22,410,53,74,.716,0,0,,53,74,.716,.716,24,37,.649,31,44,75,28,12,25,16,63,130
Derrick Jones,SF,21,MIA,37,5,668,104,203,.512,19,52,.365,85,151,.563,.559,45,73,.616,67,95,162,18,30,26,25,72,272
Jalen Jones,SF,25,CLE,16,0,214,26,62,.419,10,28,.357,16,34,.471,.500,19,27,.704,11,23,34,7,9,2,8,27,81
Tyus Jones,PG,22,MIN,43,6,873,90,237,.380,22,74,.297,68,163,.417,.426,32,38,.842,13,59,72,170,54,3,27,39,234
DeAndre Jordan,C,30,DAL,50,50,1554,208,323,.644,0,0,,208,323,.644,.644,135,198,.682,161,525,686,99,33,53,111,125,551
Cory Joseph,PG,27,IND,52,2,1338,152,354,.429,40,117,.342,112,237,.473,.486,21,30,.700,22,160,182,203,60,11,61,84,365
Frank Kaminsky,C,25,CHO,24,0,271,47,97,.485,15,43,.349,32,54,.593,.562,22,35,.629,19,41,60,26,5,5,18,25,131
Enes Kanter,C,26,NYK,44,23,1128,251,468,.536,7,22,.318,244,446,.547,.544,105,129,.814,171,290,461,84,18,17,79,106,614
Luke Kennard,SG,22,DET,33,9,665,102,243,.420,43,120,.358,59,123,.480,.508,19,26,.731,5,87,92,42,13,6,28,43,266
Michael Kidd-Gilchrist,PF,25,CHO,45,1,893,131,270,.485,10,35,.286,121,235,.515,.504,83,107,.776,77,123,200,44,25,34,33,123,355
George King,SF,25,PHO,1,0,6,0,0,,0,0,,0,0,,,0,0,,0,1,1,0,0,0,0,0,0
Maxi Kleber,PF,27,DAL,47,10,900,103,232,.444,46,137,.336,57,95,.600,.543,39,49,.796,55,135,190,35,25,58,30,86,291
Brandon Knight,PG,27,HOU,12,0,118,11,47,.234,5,32,.156,6,15,.400,.287,9,11,.818,1,8,9,9,2,0,5,14,36
Kevin Knox,PF,19,NYK,44,26,1216,196,524,.374,71,209,.340,125,315,.397,.442,86,123,.699,37,149,186,40,25,14,59,105,549
Furkan Korkmaz,SG,21,PHI,42,6,595,86,216,.398,44,131,.336,42,85,.494,.500,29,36,.806,13,83,96,47,26,2,23,53,245
Luke Kornet,PF,23,NYK,24,10,366,57,133,.429,37,87,.425,20,46,.435,.568,19,23,.826,14,46,60,31,14,12,14,18,170
Kyle Korver,SG-PF,37,TOT,48,0,898,144,322,.447,95,226,.420,49,96,.510,.595,44,53,.830,6,98,104,48,13,9,41,72,427
Kyle Korver,PF,37,CLE,16,0,251,35,76,.461,25,54,.463,10,22,.455,.625,13,16,.813,0,29,29,17,3,2,17,22,108
Kyle Korver,SG,37,UTA,32,0,647,109,246,.443,70,172,.407,39,74,.527,.585,31,37,.838,6,69,75,31,10,7,24,50,319
Kosta Koufos,C,29,SAC,29,1,365,53,107,.495,0,0,,53,107,.495,.495,6,15,.400,40,94,134,26,12,13,20,52,112
Rodions Kurucs,SF,20,BRK,37,25,777,130,278,.468,29,98,.296,101,180,.561,.520,50,56,.893,38,104,142,24,23,10,44,86,339
Kyle Kuzma,SF,23,LAL,49,47,1606,348,750,.464,91,297,.306,257,453,.567,.525,132,172,.767,42,241,283,120,33,18,103,111,919
Skal Labissiere,PF,22,SAC,12,0,101,12,27,.444,3,10,.300,9,17,.529,.500,6,11,.545,2,18,20,5,2,2,6,20,33
Jeremy Lamb,SG,26,CHO,49,49,1396,264,599,.441,66,194,.340,198,405,.489,.496,129,150,.860,39,235,274,97,47,13,48,92,723
Zach LaVine,SG,23,CHI,46,45,1557,372,819,.454,79,230,.343,293,589,.497,.502,227,262,.866,23,180,203,191,44,17,157,104,1050
Jake Layman,SF,24,POR,41,25,696,118,227,.520,37,103,.359,81,124,.653,.601,19,26,.731,32,83,115,26,18,14,24,51,292
T.J. Leaf,PF,21,IND,31,0,252,45,84,.536,4,19,.211,41,65,.631,.560,8,14,.571,17,40,57,14,4,6,10,21,102
Courtney Lee,SG,33,NYK,12,2,160,21,47,.447,5,16,.313,16,31,.516,.500,9,14,.643,6,21,27,16,8,2,5,13,56
Damion Lee,SG,26,GSW,17,0,202,30,63,.476,14,33,.424,16,30,.533,.587,11,13,.846,4,28,32,3,8,0,8,19,85
Alex Len,C,25,ATL,48,20,945,192,397,.484,24,86,.279,168,311,.540,.514,91,135,.674,107,173,280,48,18,47,73,127,499
Kawhi Leonard,SF,27,TOR,39,39,1367,375,751,.499,70,190,.368,305,561,.544,.546,256,299,.856,54,256,310,123,75,19,80,60,1076
Meyers Leonard,C,26,POR,48,1,702,108,198,.545,43,92,.467,65,106,.613,.654,35,40,.875,40,153,193,60,13,9,35,80,294
Jon Leuer,PF,29,DET,31,1,343,60,99,.606,0,9,.000,60,90,.667,.606,22,29,.759,22,63,85,12,12,4,21,51,142
Caris LeVert,SF,24,BRK,14,14,416,97,204,.475,19,61,.311,78,143,.545,.522,44,61,.721,14,46,60,52,17,5,30,34,257
Damian Lillard,PG,28,POR,51,51,1801,443,985,.450,145,390,.372,298,595,.501,.523,316,348,.908,41,192,233,319,55,25,142,91,1347
Jeremy Lin,PG,30,ATL,47,1,923,165,352,.469,41,121,.339,124,231,.537,.527,135,161,.839,15,94,109,167,34,6,93,85,506
Shaun Livingston,PG,33,GSW,41,0,630,76,157,.484,0,2,.000,76,155,.490,.484,35,43,.814,28,52,80,81,21,19,25,50,187
Zach Lofton,SG,26,DET,1,0,4,0,1,.000,0,1,.000,0,0,,.000,0,0,,0,0,0,0,1,0,1,0,0
Kevon Looney,C,22,GSW,52,22,1092,154,247,.623,1,10,.100,153,237,.646,.626,48,77,.623,137,173,310,96,31,45,35,145,357
Brook Lopez,C,30,MIL,51,51,1426,223,485,.460,129,333,.387,94,152,.618,.593,53,66,.803,19,191,210,52,24,108,49,112,628
Robin Lopez,C,30,CHI,45,7,759,120,229,.524,5,18,.278,115,211,.545,.535,31,46,.674,61,71,132,41,8,41,58,74,276
Kevin Love,PF,30,CLE,4,4,136,21,65,.323,7,24,.292,14,41,.341,.377,27,33,.818,10,44,54,14,1,1,10,14,76
Kyle Lowry,PG,32,TOR,42,42,1442,196,479,.409,90,282,.319,106,197,.538,.503,110,130,.846,24,163,187,388,58,22,119,105,592
Jordan Loyd,PG,25,TOR,5,0,24,3,5,.600,2,2,1.000,1,3,.333,.800,4,4,1.000,1,6,7,2,0,0,2,2,12
Kalin Lucas,PG,29,DET,1,0,6,0,1,.000,0,1,.000,0,0,,.000,2,2,1.000,0,3,3,1,0,0,0,1,2
Timothe Luwawu-Cabarrot,SF,23,OKC,21,1,123,13,43,.302,5,22,.227,8,21,.381,.360,4,6,.667,4,14,18,4,4,1,5,14,35
Tyler Lydon,PF,22,DEN,20,0,79,8,16,.500,4,10,.400,4,6,.667,.625,1,3,.333,5,9,14,4,2,0,4,9,21
Trey Lyles,PF,23,DEN,50,1,935,174,415,.419,41,161,.255,133,254,.524,.469,67,97,.691,39,169,208,68,25,20,55,80,456
Shelvin Mack,PG,28,MEM,51,3,1162,159,375,.424,45,122,.369,114,253,.451,.484,53,75,.707,18,82,100,177,42,3,60,76,416
Daryl Macon,SG,23,DAL,3,0,5,1,1,1.000,0,0,,1,1,1.000,1.000,0,0,,0,0,0,0,1,0,1,0,2
J.P. Macura,SG,23,CHO,1,0,14,2,8,.250,0,4,.000,2,4,.500,.250,0,0,,0,2,2,2,0,0,0,0,4
Ian Mahinmi,C,32,WAS,30,6,436,39,80,.488,1,12,.083,38,68,.559,.494,40,59,.678,39,67,106,24,23,15,19,74,119
Thon Maker,C,21,MIL,35,0,409,59,134,.440,26,78,.333,33,56,.589,.537,20,37,.541,17,79,96,18,10,18,9,55,164
Boban Marjanovic,C,30,LAC,34,9,359,82,134,.612,0,2,.000,82,132,.621,.612,68,90,.756,51,92,143,20,9,17,35,56,232
Lauri Markkanen,PF,21,CHI,30,29,947,188,437,.430,74,194,.381,114,243,.469,.515,75,87,.862,33,208,241,30,24,23,47,67,525
Jarell Martin,PF,24,ORL,28,1,234,30,71,.423,10,30,.333,20,41,.488,.493,7,8,.875,7,39,46,13,2,7,10,31,77
Frank Mason,PG,24,SAC,33,0,383,55,136,.404,9,46,.196,46,90,.511,.438,33,48,.688,4,32,36,81,16,4,29,26,152
Wesley Matthews,SF,32,DAL,44,44,1312,194,469,.414,100,263,.380,94,206,.456,.520,87,110,.791,20,82,102,100,33,12,58,102,575
Luc Mbah a Moute,PF,32,LAC,4,0,61,8,18,.444,2,6,.333,6,12,.500,.500,2,5,.400,2,5,7,2,1,1,2,8,20
Patrick McCaw,SG,23,TOT,9,0,101,3,16,.188,1,8,.125,2,8,.250,.219,2,2,1.000,3,12,15,7,5,0,8,8,9
Patrick McCaw,SG,23,CLE,3,0,53,2,9,.222,1,4,.250,1,5,.200,.278,0,0,,0,3,3,2,2,0,3,1,5
Patrick McCaw,SG,23,TOR,6,0,48,1,7,.143,0,4,.000,1,3,.333,.143,2,2,1.000,3,9,12,5,3,0,5,7,4
CJ McCollum,SG,27,POR,51,51,1733,421,910,.463,109,304,.359,312,606,.515,.523,120,145,.828,44,153,197,139,42,18,81,123,1071
T.J. McConnell,PG,26,PHI,47,1,993,140,259,.541,10,32,.313,130,227,.573,.560,20,26,.769,19,88,107,183,56,14,62,80,310
Doug McDermott,SF,27,IND,51,0,891,121,261,.464,57,147,.388,64,114,.561,.573,45,52,.865,10,58,68,42,11,6,28,69,344
JaVale McGee,C,31,LAL,46,37,999,219,369,.593,1,8,.125,218,361,.604,.595,58,90,.644,110,204,314,35,29,96,69,113,497
Rodney McGruder,SG,27,MIA,47,44,1208,153,376,.407,65,178,.365,88,198,.444,.493,37,49,.755,41,129,170,97,27,8,56,97,408
Alfonzo McKinnie,SF,26,GSW,43,1,634,91,189,.481,28,79,.354,63,110,.573,.556,15,29,.517,56,105,161,16,10,10,20,83,225
Ben McLemore,SG,25,SAC,19,0,158,25,64,.391,17,41,.415,8,23,.348,.523,8,12,.667,3,14,17,4,6,3,5,22,75
Jordan McRae,SG,27,WAS,13,0,88,15,34,.441,5,9,.556,10,25,.400,.515,5,9,.556,3,9,12,5,4,1,3,3,40
Salah Mejri,C,32,DAL,16,1,108,15,28,.536,0,2,.000,15,26,.577,.536,7,8,.875,12,26,38,6,2,3,4,16,37
De'Anthony Melton,PG,20,PHO,33,25,675,71,193,.368,24,77,.312,47,116,.405,.430,15,18,.833,16,70,86,110,50,17,55,85,181
Chimezie Metu,PF,21,SAS,22,0,115,16,47,.340,0,2,.000,16,45,.356,.340,13,17,.765,8,19,27,11,5,2,12,10,45
Khris Middleton,SF,27,MIL,49,49,1529,304,687,.443,116,303,.383,188,384,.490,.527,129,153,.843,24,259,283,206,53,4,111,114,853
C.J. Miles,SF,31,TOR,38,1,540,66,200,.330,40,132,.303,26,68,.382,.430,31,40,.775,10,54,64,21,17,9,20,58,203
Darius Miller,SF,28,NOP,48,10,1201,124,312,.397,90,239,.377,34,73,.466,.542,34,40,.850,7,77,84,81,33,19,38,117,372
Patty Mills,PG,30,SAS,54,0,1281,180,416,.433,98,244,.402,82,172,.477,.550,66,77,.857,16,111,127,160,38,9,63,82,524
Paul Millsap,PF,33,DEN,44,40,1130,193,398,.485,30,85,.353,163,313,.521,.523,112,155,.723,88,196,284,84,53,36,58,108,528
Shake Milton,SG,22,PHI,13,0,126,20,46,.435,10,25,.400,10,21,.476,.543,4,5,.800,7,13,20,13,4,3,3,14,54
Nikola Mirotic,PF,27,NOP,32,22,925,182,407,.447,85,231,.368,97,176,.551,.552,85,101,.842,46,218,264,35,21,25,37,86,534
Donovan Mitchell,SG,22,UTA,50,50,1658,408,968,.421,109,336,.324,299,632,.473,.478,195,245,.796,34,158,192,202,77,18,139,134,1120
Naz Mitrou-Long,SG,25,UTA,10,0,39,2,8,.250,1,6,.167,1,2,.500,.313,0,0,,0,2,2,4,0,0,3,5,5
Malik Monk,SG,20,CHO,49,0,919,179,446,.401,83,240,.346,96,206,.466,.494,76,84,.905,9,78,87,92,27,13,66,71,517
Greg Monroe,C,28,TOR,36,2,385,66,145,.455,0,4,.000,66,141,.468,.455,32,57,.561,55,87,142,15,12,8,29,54,164
E'Twaun Moore,SF,29,NOP,44,35,1294,221,458,.483,60,144,.417,161,314,.513,.548,38,50,.760,33,77,110,90,34,7,49,99,540
Eric Moreland,PF,27,PHO,1,0,5,0,0,,0,0,,0,0,,,0,0,,0,3,3,0,0,0,0,1,0
Jaylen Morris,SG,23,MIL,4,0,29,4,10,.400,1,3,.333,3,7,.429,.450,1,2,.500,0,5,5,4,2,0,1,1,10
Marcus Morris,PF,29,BOS,48,31,1315,254,532,.477,104,248,.419,150,284,.528,.575,94,108,.870,43,248,291,69,30,16,61,120,706
Markieff Morris,PF,29,WAS,34,15,883,143,328,.436,48,144,.333,95,184,.516,.509,57,73,.781,41,133,174,60,25,20,47,117,391
Monte Morris,PG,23,DEN,52,4,1297,222,454,.489,64,144,.444,158,310,.510,.559,38,48,.792,23,115,138,205,49,2,35,60,546
Johnathan Motley,PF,23,LAC,12,0,83,22,44,.500,0,2,.000,22,42,.524,.500,14,23,.609,13,13,26,5,2,1,10,13,58
Emmanuel Mudiay,PG,22,NYK,39,32,1036,219,483,.453,41,133,.308,178,350,.509,.496,95,125,.760,25,95,120,152,31,13,83,70,574
Jamal Murray,PG,21,DEN,47,46,1574,328,759,.432,91,249,.365,237,510,.465,.492,122,146,.836,45,160,205,228,37,18,112,99,869
Dzanan Musa,SG,19,BRK,7,0,26,6,14,.429,0,6,.000,6,8,.750,.429,0,2,.000,1,2,3,1,2,0,3,1,12
Mike Muscala,PF,27,PHI,46,5,1009,108,275,.393,68,197,.345,40,78,.513,.516,57,70,.814,51,145,196,61,18,27,42,109,341
Sviatoslav Mykhailiuk,SF,21,LAL,38,0,408,43,129,.333,27,84,.321,16,45,.356,.438,9,16,.563,8,24,32,32,13,0,20,25,122
Abdel Nader,SF,25,OKC,33,1,319,50,108,.463,15,41,.366,35,67,.522,.532,12,15,.800,6,52,58,9,7,2,13,35,127
Larry Nance,C,26,CLE,43,17,1089,149,283,.527,13,41,.317,136,242,.562,.549,64,90,.711,93,233,326,130,61,29,55,122,375
Shabazz Napier,PG,27,BRK,42,1,743,131,331,.396,60,163,.368,71,168,.423,.486,94,114,.825,13,63,76,96,34,13,52,52,416
Raul Neto,PG,26,UTA,19,1,228,36,70,.514,9,27,.333,27,43,.628,.579,13,14,.929,2,27,29,38,8,0,18,21,94
Georges Niang,PF,25,UTA,40,0,303,44,102,.431,28,70,.400,16,32,.500,.569,9,11,.818,7,46,53,20,7,3,13,36,125
Joakim Noah,C,33,MEM,25,0,331,44,92,.478,0,0,,44,92,.478,.478,26,41,.634,31,82,113,33,11,14,27,42,114
Nerlens Noel,C,24,OKC,47,2,675,102,176,.580,0,0,,102,176,.580,.580,35,48,.729,78,137,215,25,47,68,29,107,239
Dirk Nowitzki,PF,40,DAL,21,0,214,31,90,.344,17,57,.298,14,33,.424,.439,9,11,.818,0,37,37,7,1,6,5,28,88
Frank Ntilikina,PG,20,NYK,41,16,872,94,275,.342,32,110,.291,62,165,.376,.400,21,28,.750,10,72,82,116,30,14,54,100,241
James Nunnally,SF,28,TOT,15,0,102,12,34,.353,8,25,.320,4,9,.444,.471,4,4,1.000,0,5,5,7,1,0,1,10,36
James Nunnally,SF,28,MIN,13,0,64,9,21,.429,5,13,.385,4,8,.500,.548,4,4,1.000,0,4,4,5,1,0,1,4,27
James Nunnally,SF,28,HOU,2,0,38,3,13,.231,3,12,.250,0,1,.000,.346,0,0,,0,1,1,2,0,0,0,6,9
Jusuf Nurkic,C,24,POR,51,51,1397,289,577,.501,3,25,.120,286,552,.518,.503,192,255,.753,175,355,530,163,55,80,119,169,773
David Nwaba,SG,26,CLE,22,6,361,47,105,.448,9,35,.257,38,70,.543,.490,34,54,.630,12,50,62,16,14,7,9,38,137
Royce O'Neale,SF,25,UTA,54,9,987,96,208,.462,37,95,.389,59,113,.522,.550,24,33,.727,17,162,179,71,36,16,48,103,253
Kyle O'Quinn,C,28,IND,28,0,199,35,74,.473,1,10,.100,34,64,.531,.480,9,10,.900,17,49,66,31,3,15,17,37,80
Semi Ojeleye,PF,24,BOS,38,2,392,47,112,.420,19,65,.292,28,47,.596,.504,14,20,.700,16,43,59,12,6,2,12,27,127
Jahlil Okafor,C,23,NOP,34,10,460,105,179,.587,0,1,.000,105,178,.590,.587,34,47,.723,51,97,148,17,8,24,25,60,244
Elie Okobo,PG,21,PHO,36,8,669,83,213,.390,28,93,.301,55,120,.458,.455,25,30,.833,8,64,72,92,23,5,45,83,219
Josh Okogie,SG,20,MIN,44,22,968,105,296,.355,33,132,.250,72,164,.439,.410,74,99,.747,23,104,127,51,40,16,41,100,317
Victor Oladipo,SG,26,IND,36,36,1147,249,588,.423,74,216,.343,175,372,.470,.486,103,141,.730,21,181,202,186,60,11,82,72,675
Kelly Olynyk,PF,27,MIA,48,5,968,142,311,.457,68,199,.342,74,112,.661,.566,87,112,.777,43,167,210,79,28,16,67,104,439
Cedi Osman,SF,23,CLE,51,50,1608,234,552,.424,78,241,.324,156,311,.502,.495,97,128,.758,29,207,236,115,39,9,85,133,643
Kelly Oubre,SF,23,TOT,52,7,1386,249,582,.428,79,250,.316,170,332,.512,.496,129,164,.787,46,184,230,53,51,46,67,135,706
Kelly Oubre,SF,23,WAS,29,7,755,132,305,.433,41,132,.311,91,173,.526,.500,68,85,.800,24,105,129,20,27,20,30,71,373
Kelly Oubre,SF,23,PHO,23,0,631,117,277,.422,38,118,.322,79,159,.497,.491,61,79,.772,22,79,101,33,24,26,37,64,333
Zaza Pachulia,C,34,DET,41,3,610,59,135,.437,0,4,.000,59,131,.450,.437,70,91,.769,79,116,195,61,29,11,35,100,188
Jabari Parker,PF,23,CHI,39,17,1042,220,464,.474,37,114,.325,183,350,.523,.514,79,108,.731,41,200,241,84,23,14,84,87,556
Tony Parker,PG,36,CHO,45,0,828,173,378,.458,9,39,.231,164,339,.484,.470,81,111,.730,11,55,66,176,17,5,60,46,436
Chandler Parsons,SF,30,MEM,3,3,46,7,17,.412,3,10,.300,4,7,.571,.500,0,0,,1,3,4,2,1,1,2,7,17
Patrick Patterson,PF,29,OKC,51,3,745,74,195,.379,42,123,.341,32,72,.444,.487,18,29,.621,36,86,122,28,13,12,18,36,208
Chris Paul,PG,33,HOU,29,29,943,153,360,.425,59,167,.353,94,193,.487,.507,82,101,.812,17,100,117,229,59,8,83,73,447
Cameron Payne,PG,24,TOT,40,13,712,96,223,.430,25,84,.298,71,139,.511,.487,33,41,.805,13,59,72,106,28,9,45,64,250
Cameron Payne,PG,24,CHI,31,12,536,69,168,.411,16,59,.271,53,109,.486,.458,22,25,.880,10,43,53,83,20,6,34,49,176
Cameron Payne,PG,24,CLE,9,1,176,27,55,.491,9,25,.360,18,30,.600,.573,11,16,.688,3,16,19,23,8,3,11,15,74
Elfrid Payton,PG,24,NOP,19,19,512,75,171,.439,13,37,.351,62,134,.463,.477,23,31,.742,14,56,70,111,22,5,45,37,186
Gary Payton,PG,26,WAS,3,0,16,5,8,.625,1,2,.500,4,6,.667,.688,0,0,,1,1,2,4,3,1,1,2,11
Theo Pinson,SG,23,BRK,10,0,135,16,43,.372,7,25,.280,9,18,.500,.453,10,10,1.000,2,19,21,15,4,0,12,8,49
Mason Plumlee,C,28,DEN,52,12,1026,162,270,.600,1,5,.200,161,265,.608,.602,71,132,.538,103,199,302,134,46,46,76,162,396
Miles Plumlee,C,30,ATL,18,0,173,32,48,.667,0,0,,32,48,.667,.667,16,30,.533,16,23,39,17,6,4,10,14,80
Jakob Poeltl,C,23,SAS,50,6,729,108,170,.635,0,0,,108,170,.635,.635,37,67,.552,103,129,232,61,9,33,35,77,253
Quincy Pondexter,SF,30,SAS,39,0,220,21,43,.488,6,16,.375,15,27,.556,.558,27,35,.771,7,31,38,18,9,1,10,19,75
Otto Porter,SF,25,WAS,40,27,1153,197,429,.459,65,172,.378,132,257,.514,.535,46,58,.793,38,185,223,78,63,20,39,75,505
Bobby Portis,PF,23,CHI,22,6,531,122,271,.450,27,72,.375,95,199,.477,.500,39,50,.780,46,115,161,29,11,8,29,61,310
Dwight Powell,C,27,DAL,48,0,798,148,255,.580,14,65,.215,134,190,.705,.608,96,130,.738,61,135,196,46,23,29,39,118,406
Norman Powell,SG,25,TOR,31,2,578,94,189,.497,32,80,.400,62,109,.569,.582,28,36,.778,4,55,59,47,23,7,28,53,248
Alex Poythress,PF,25,ATL,18,1,243,35,65,.538,7,18,.389,28,47,.596,.592,11,21,.524,24,35,59,13,3,8,10,39,88
Zhou Qi,PF,23,HOU,1,0,1,1,1,1.000,0,0,,1,1,1.000,1.000,0,0,,0,0,0,0,0,0,0,0,2
Ivan Rabb,PF,21,MEM,23,0,194,37,61,.607,0,2,.000,37,59,.627,.607,15,22,.682,25,42,67,14,2,4,16,23,89
Chasson Randle,PG,25,WAS,22,0,339,43,96,.448,21,47,.447,22,49,.449,.557,23,34,.676,6,20,26,46,12,1,25,42,130
Julius Randle,C,24,NOP,47,27,1390,343,631,.544,28,88,.318,315,543,.580,.566,222,301,.738,100,339,439,139,28,28,121,162,936
J.J. Redick,SG,34,PHI,50,37,1553,308,691,.446,153,398,.384,155,293,.529,.556,147,163,.902,15,94,109,138,20,10,70,87,916
Davon Reed,SG,23,IND,6,0,15,1,3,.333,1,1,1.000,0,2,.000,.500,0,0,,0,1,1,2,0,0,1,1,3
Josh Richardson,SG,25,MIA,49,49,1695,290,721,.402,119,321,.371,171,400,.428,.485,148,171,.865,37,144,181,186,55,23,83,137,847
Malachi Richardson,SG,23,TOR,22,0,103,9,29,.310,8,25,.320,1,4,.250,.448,4,5,.800,2,11,13,0,1,0,8,13,30
Austin Rivers,SG-PG,26,TOT,49,15,1391,158,396,.399,73,229,.319,85,167,.509,.491,37,68,.544,20,103,123,127,32,17,51,144,426
Austin Rivers,SG,26,WAS,29,2,683,76,194,.392,33,106,.311,43,88,.489,.477,25,46,.543,11,60,71,58,18,10,36,72,210
Austin Rivers,PG,26,HOU,20,13,708,82,202,.406,40,123,.325,42,79,.532,.505,12,22,.545,9,43,52,69,14,7,15,72,216
Devin Robinson,SF,23,WAS,4,0,32,8,13,.615,0,0,,8,13,.615,.615,3,6,.500,2,5,7,2,3,1,0,2,19
Duncan Robinson,PF,24,MIA,4,0,29,2,6,.333,2,6,.333,0,0,,.500,0,0,,0,5,5,0,1,0,0,1,6
Glenn Robinson,SF,25,DET,31,17,424,44,117,.376,12,42,.286,32,75,.427,.427,27,33,.818,9,29,38,13,11,5,15,28,127
Jerome Robinson,SG,21,LAC,17,0,150,24,51,.471,12,30,.400,12,21,.571,.588,0,2,.000,3,14,17,3,2,2,2,22,60
Mitchell Robinson,C,20,NYK,36,12,618,83,121,.686,0,0,,83,121,.686,.686,23,49,.469,76,70,146,20,26,71,19,110,189
Rajon Rondo,PG,32,LAL,19,7,531,73,167,.437,16,43,.372,57,124,.460,.485,10,17,.588,13,87,100,147,19,2,45,48,172
Derrick Rose,PG,30,MIN,39,13,1121,278,581,.478,53,129,.411,225,452,.498,.524,105,123,.854,25,84,109,185,25,10,65,44,714
Terrence Ross,SG,27,ORL,53,0,1404,281,652,.431,124,329,.377,157,323,.486,.526,63,75,.840,19,154,173,82,49,20,55,87,749
Terry Rozier,PG,24,BOS,52,8,1195,165,435,.379,77,217,.355,88,218,.404,.468,51,63,.810,25,188,213,162,48,14,45,64,458
Ricky Rubio,PG,28,UTA,47,46,1348,210,522,.402,64,197,.325,146,325,.449,.464,121,142,.852,19,145,164,286,61,9,138,126,605
D'Angelo Russell,PG,22,BRK,53,53,1573,406,925,.439,143,382,.374,263,543,.484,.516,88,108,.815,29,168,197,341,61,16,154,90,1043
Domantas Sabonis,C,22,IND,50,5,1244,278,467,.595,7,11,.636,271,456,.594,.603,147,198,.742,132,332,464,138,34,24,108,158,710
Brandon Sampson,SG,21,CHI,2,0,25,2,4,.500,1,3,.333,1,1,1.000,.625,0,0,,0,3,3,1,0,0,0,3,5
Dario Saric,PF,24,TOT,51,14,1254,173,419,.413,67,199,.337,106,220,.482,.493,75,86,.872,73,212,285,76,27,6,59,114,488
Dario Saric,PF,24,PHI,13,13,396,48,132,.364,21,70,.300,27,62,.435,.443,27,30,.900,21,65,86,26,4,3,25,39,144
Dario Saric,PF,24,MIN,38,1,858,125,287,.436,46,129,.357,79,158,.500,.516,48,56,.857,52,147,199,50,23,3,34,75,344
Tomas Satoransky,SG,27,WAS,52,26,1243,149,304,.490,38,91,.418,111,213,.521,.553,67,84,.798,41,112,153,209,53,9,61,104,403
Dennis Schroder,PG,25,OKC,50,10,1428,294,695,.423,74,209,.354,220,486,.453,.476,119,143,.832,21,149,170,213,46,8,119,110,781
Mike Scott,PF,30,LAC,50,0,702,88,219,.402,49,128,.383,39,91,.429,.514,12,18,.667,23,141,164,41,17,8,25,85,237
Thabo Sefolosha,SF,34,UTA,26,0,289,29,58,.500,13,28,.464,16,30,.533,.612,8,14,.571,4,69,73,10,23,1,15,23,79
Wayne Selden,SG,24,TOT,46,4,754,100,238,.420,32,93,.344,68,145,.469,.487,33,45,.733,20,50,70,61,15,7,41,72,265
Wayne Selden,SG,24,MEM,32,0,455,65,161,.404,20,63,.317,45,98,.459,.466,22,29,.759,16,28,44,36,10,6,23,48,172
Wayne Selden,SG,24,CHI,14,4,299,35,77,.455,12,30,.400,23,47,.489,.532,11,16,.688,4,22,26,25,5,1,18,24,93
Collin Sexton,PG,20,CLE,53,43,1573,290,719,.403,49,128,.383,241,591,.408,.437,130,153,.850,37,123,160,148,27,3,118,129,759
Landry Shamet,SG,21,PHI,53,3,1074,151,339,.445,97,239,.406,54,100,.540,.588,44,54,.815,14,63,77,58,24,8,25,102,443
Iman Shumpert,SG,28,SAC,41,39,1064,128,340,.376,71,197,.360,57,143,.399,.481,34,41,.829,19,104,123,85,47,19,37,90,361
Pascal Siakam,PF,24,TOR,52,51,1635,313,557,.562,38,114,.333,275,443,.621,.596,137,172,.797,83,278,361,150,50,34,93,160,801
Ben Simmons,PG,22,PHI,52,52,1752,356,619,.575,0,1,.000,356,618,.576,.575,169,288,.587,118,372,490,419,68,40,179,131,881
Jonathon Simmons,SG,29,ORL,41,9,845,104,286,.364,19,83,.229,85,203,.419,.397,56,72,.778,23,77,100,95,18,14,56,68,283
Kobi Simmons,G,21,CLE,1,0,2,0,0,,0,0,,0,0,,,0,0,,0,0,0,0,0,0,0,0,0
Anfernee Simons,SG,19,POR,10,0,57,7,24,.292,0,8,.000,7,16,.438,.292,1,4,.250,0,7,7,4,0,0,6,3,15
Marcus Smart,SG,24,BOS,51,31,1364,133,330,.403,76,209,.364,57,121,.471,.518,66,84,.786,33,108,141,205,89,20,71,127,408
Dennis Smith,PG,21,DAL,32,32,908,157,357,.440,43,125,.344,114,232,.491,.500,57,82,.695,18,79,97,138,40,11,100,82,414
Ish Smith,PG,30,DET,26,0,591,91,225,.404,29,83,.349,62,142,.437,.469,12,18,.667,1,44,45,73,11,7,26,56,223
J.R. Smith,SG,33,CLE,11,4,222,27,79,.342,12,39,.308,15,40,.375,.418,8,10,.800,0,18,18,21,11,3,11,19,74
Jason Smith,C-PF,32,TOT,18,1,170,19,50,.380,7,19,.368,12,31,.387,.450,12,14,.857,14,34,48,13,3,7,12,27,57
Jason Smith,C,32,WAS,12,1,130,15,37,.405,4,10,.400,11,27,.407,.459,10,12,.833,11,26,37,12,1,5,7,21,44
Jason Smith,PF,32,MIL,6,0,40,4,13,.308,3,9,.333,1,4,.250,.423,2,2,1.000,3,8,11,1,2,2,5,6,13
Tony Snell,SG,27,MIL,51,6,874,114,247,.462,62,148,.419,52,99,.525,.587,33,37,.892,21,87,108,44,19,10,19,58,323
Ray Spalding,PF,21,DAL,1,0,1,0,0,,0,0,,0,0,,,0,0,,0,0,0,0,0,0,0,0,0
Omari Spellman,PF,21,ATL,35,10,592,71,178,.399,32,93,.344,39,85,.459,.489,26,36,.722,51,85,136,29,20,21,25,57,200
Nik Stauskas,SG,25,POR,44,0,673,96,229,.419,43,125,.344,53,104,.510,.513,32,36,.889,10,70,80,62,14,4,40,31,267
D.J. Stephens,SG,28,MEM,1,0,7,1,2,.500,0,0,,1,2,.500,.500,0,0,,0,0,0,0,1,0,1,0,2
Lance Stephenson,SG,28,LAL,52,0,830,149,334,.446,59,150,.393,90,184,.489,.534,34,53,.642,24,135,159,107,33,5,69,86,391
Edmond Sumner,PG,23,IND,13,2,105,8,32,.250,1,13,.077,7,19,.368,.266,3,7,.429,5,11,16,5,6,3,6,16,20
Caleb Swanigan,PF,21,POR,18,0,145,14,44,.318,1,5,.200,13,39,.333,.330,6,7,.857,13,39,52,7,4,0,16,22,35
Jayson Tatum,SF,20,BOS,52,52,1608,314,697,.451,85,226,.376,229,471,.486,.511,130,152,.855,52,267,319,96,51,41,77,109,843
Jeff Teague,PG,30,MIN,31,31,939,119,293,.406,28,82,.341,91,211,.431,.454,91,111,.820,11,64,75,250,35,13,72,65,357
Garrett Temple,SG,32,MEM,49,49,1530,166,387,.429,74,210,.352,92,177,.520,.525,57,76,.750,18,134,152,69,50,25,54,134,463
Milos Teodosic,PG,31,LAC,15,0,150,17,40,.425,10,27,.370,7,13,.538,.550,4,7,.571,3,13,16,32,3,1,21,27,48
Jared Terrell,SG,23,MIN,7,0,67,8,26,.308,4,11,.364,4,15,.267,.385,1,2,.500,1,2,3,7,3,1,7,8,21
Emanuel Terry,PF,22,PHO,2,0,20,4,6,.667,0,0,,4,6,.667,.667,1,2,.500,2,4,6,1,3,0,2,4,9
Daniel Theis,C,26,BOS,38,2,565,90,167,.539,16,41,.390,74,126,.587,.587,41,56,.732,58,96,154,42,12,22,21,102,237
Khyri Thomas,SG,22,DET,14,0,120,15,39,.385,9,22,.409,6,17,.353,.500,6,9,.667,2,10,12,4,4,4,3,11,45
Lance Thomas,PF,30,NYK,23,11,373,30,78,.385,6,30,.200,24,48,.500,.423,18,21,.857,11,47,58,11,15,6,13,44,84
Klay Thompson,SG,28,GSW,51,51,1743,436,938,.465,147,384,.383,289,554,.522,.543,94,116,.810,21,184,205,104,59,32,81,110,1113
Tristan Thompson,C,27,CLE,35,35,1043,173,329,.526,0,0,,173,329,.526,.526,55,85,.647,154,235,389,75,28,16,50,81,401
Sindarius Thornwell,SG,24,LAC,35,0,181,13,32,.406,2,10,.200,11,22,.500,.438,13,19,.684,2,25,27,10,4,2,13,29,41
Anthony Tolliver,PF,33,MIN,36,0,544,50,120,.417,41,106,.387,9,14,.643,.588,21,28,.750,11,69,80,20,11,10,19,49,162
Karl-Anthony Towns,C,23,MIN,52,52,1724,429,856,.501,91,242,.376,338,614,.550,.554,236,281,.840,176,454,630,166,50,96,147,195,1185
Gary Trent,SG,20,POR,7,0,33,5,17,.294,3,8,.375,2,9,.222,.382,1,4,.250,0,4,4,1,0,1,1,1,14
Allonzo Trier,SG,23,NYK,44,3,979,154,342,.450,28,75,.373,126,267,.472,.491,121,144,.840,24,107,131,90,20,14,80,72,457
P.J. Tucker,PF,33,HOU,52,52,1840,145,359,.404,94,255,.369,51,104,.490,.535,31,49,.633,76,243,319,65,81,23,45,162,415
Evan Turner,PG,30,POR,51,2,1228,165,351,.470,7,42,.167,158,309,.511,.480,54,78,.692,32,206,238,200,27,14,88,89,391
Myles Turner,C,22,IND,47,47,1330,249,492,.506,39,102,.382,210,390,.538,.546,81,114,.711,67,269,336,80,30,124,68,119,618
Ekpe Udoh,C,31,UTA,33,0,186,27,38,.711,0,0,,27,38,.711,.711,10,16,.625,11,26,37,13,3,17,8,23,64
Tyler Ulis,PG,23,CHI,1,0,1,0,0,,0,0,,0,0,,,0,0,,0,0,0,0,0,0,0,0,0
Jonas Valanciunas,C,26,TOR,30,10,564,149,259,.575,9,30,.300,140,229,.611,.593,77,94,.819,54,162,216,29,13,23,39,82,384
Jarred Vanderbilt,PF,19,DEN,1,0,4,0,0,,0,0,,0,0,,,1,2,.500,0,3,3,1,1,0,1,0,1
Fred VanVleet,PG,24,TOR,47,20,1261,172,428,.402,78,212,.368,94,216,.435,.493,69,83,.831,19,107,126,213,40,12,59,84,491
Noah Vonleh,PF,23,NYK,51,44,1358,155,340,.456,40,111,.360,115,229,.502,.515,90,126,.714,95,344,439,107,39,45,70,136,440
Nikola Vucevic,C,28,ORL,52,52,1630,454,871,.521,59,156,.378,395,715,.552,.555,110,142,.775,139,484,623,199,50,61,107,103,1077
Dwyane Wade,SG,37,MIA,41,0,1041,211,496,.425,50,152,.329,161,344,.468,.476,94,133,.707,35,116,151,177,27,19,94,69,566
Moritz Wagner,C,21,LAL,19,0,125,23,56,.411,10,27,.370,13,29,.448,.500,9,15,.600,8,23,31,8,3,3,9,16,65
Dion Waiters,SG,27,MIA,13,0,253,42,111,.378,17,63,.270,25,48,.521,.455,1,7,.143,1,28,29,32,7,1,12,10,102
Kemba Walker,PG,28,CHO,52,52,1783,443,1025,.432,165,460,.359,278,565,.492,.513,228,277,.823,27,194,221,292,62,27,133,82,1279
Lonnie Walker,SG,20,SAS,4,0,29,4,11,.364,2,4,.500,2,7,.286,.455,0,0,,0,7,7,1,1,1,1,3,10
John Wall,PG,28,WAS,32,32,1104,245,552,.444,51,169,.302,194,383,.507,.490,122,175,.697,15,101,116,279,49,29,121,71,663
Tyrone Wallace,PG,24,LAC,40,0,398,63,146,.432,2,13,.154,61,133,.459,.438,19,39,.487,16,47,63,21,16,7,17,54,147
Taurean Waller-Prince,SF,24,ATL,31,23,850,146,338,.432,63,175,.360,83,163,.509,.525,57,69,.826,14,105,119,59,33,11,63,88,412
Brad Wanamaker,PG,29,BOS,23,0,206,28,64,.438,15,28,.536,13,36,.361,.555,13,14,.929,2,20,22,33,9,1,13,15,84
T.J. Warren,SF,25,PHO,43,36,1360,297,611,.486,77,180,.428,220,431,.510,.549,101,124,.815,31,143,174,64,51,29,52,119,772
Julian Washburn,SF,27,MEM,3,0,21,0,3,.000,0,1,.000,0,2,.000,.000,0,0,,1,4,5,0,0,0,0,2,0
Yuta Watanabe,SG,24,MEM,8,0,52,5,15,.333,1,5,.200,4,10,.400,.367,3,6,.500,0,10,10,3,1,1,3,2,14
Thomas Welsh,C,22,DEN,9,0,33,5,10,.500,3,7,.429,2,3,.667,.650,1,2,.500,0,4,4,4,0,0,1,2,14
Russell Westbrook,PG,30,OKC,43,43,1523,353,844,.418,49,197,.249,304,647,.470,.447,169,262,.645,62,407,469,468,97,15,193,147,924
Derrick White,PG,24,SAS,45,33,1138,167,334,.500,31,87,.356,136,247,.551,.546,67,87,.770,22,132,154,163,45,23,67,95,432
Okaro White,PF,26,WAS,3,0,6,0,2,.000,0,2,.000,0,0,,.000,0,0,,1,1,2,0,0,0,0,0,0
Hassan Whiteside,C,29,MIA,45,45,1146,247,452,.546,2,15,.133,245,437,.561,.549,74,178,.416,171,389,560,39,26,101,78,126,570
Andrew Wiggins,SF,23,MIN,48,48,1665,312,787,.396,77,229,.336,235,558,.421,.445,154,214,.720,54,166,220,110,52,26,89,98,855
Alan Williams,PF,26,BRK,2,0,10,3,5,.600,0,1,.000,3,4,.750,.600,2,4,.500,2,6,8,2,0,0,1,0,8
C.J. Williams,SG,28,MIN,8,0,65,7,16,.438,1,7,.143,6,9,.667,.469,0,0,,1,3,4,5,1,0,4,11,15
Johnathan Williams,C,23,LAL,7,0,89,11,20,.550,0,0,,11,20,.550,.550,1,5,.200,11,10,21,4,1,4,2,20,23
Kenrich Williams,SF,24,NOP,17,0,188,25,51,.490,8,20,.400,17,31,.548,.569,2,4,.500,9,38,47,10,1,3,8,23,60
Lou Williams,SG,32,LAC,47,0,1227,290,690,.420,63,178,.354,227,512,.443,.466,261,291,.897,20,121,141,251,32,6,111,45,904
Marvin Williams,PF,32,CHO,51,51,1435,187,440,.425,103,266,.387,84,174,.483,.542,46,64,.719,44,236,280,63,47,36,28,109,523
Robert Williams,C,21,BOS,22,0,198,28,37,.757,0,0,,28,37,.757,.757,6,10,.600,19,36,55,5,6,32,8,27,62
Troy Williams,SF,24,SAC,18,0,286,40,87,.460,14,41,.341,26,46,.565,.540,9,15,.600,9,46,55,10,10,8,8,34,103
D.J. Wilson,PF,22,MIL,23,0,417,55,112,.491,24,53,.453,31,59,.525,.598,9,20,.450,20,86,106,22,10,15,11,47,143
Justise Winslow,PF,22,MIA,46,33,1351,217,505,.430,66,171,.386,151,334,.452,.495,67,101,.663,44,197,241,190,45,14,100,116,567
Christian Wood,PF,23,MIL,7,0,41,9,19,.474,2,4,.500,7,15,.467,.526,5,6,.833,4,12,16,2,0,0,2,2,25
Delon Wright,PG,26,TOR,47,2,858,121,276,.438,30,87,.345,91,189,.481,.493,43,50,.860,37,81,118,102,42,15,37,52,315
Guerschon Yabusele,PF,23,BOS,29,0,164,21,47,.447,4,17,.235,17,30,.567,.489,9,12,.750,15,18,33,12,7,7,11,27,55
Nick Young,SG,33,DEN,4,0,37,3,9,.333,3,8,.375,0,1,.000,.500,0,0,,0,1,1,2,0,1,2,4,9
Thaddeus Young,PF,30,IND,52,52,1563,289,541,.534,26,77,.338,263,464,.567,.558,56,92,.609,126,204,330,102,80,24,67,125,660
Trae Young,PG,20,ATL,52,52,1564,305,742,.411,88,288,.306,217,454,.478,.470,182,227,.802,35,131,166,384,45,12,208,87,880
Cody Zeller,C,26,CHO,35,35,857,129,231,.558,5,16,.313,124,215,.577,.569,64,76,.842,72,146,218,74,25,28,45,113,327
Ante Zizic,C,22,CLE,37,10,585,100,190,.526,0,0,,100,190,.526,.526,53,73,.726,60,125,185,24,9,14,32,64,253
Ivica Zubac,C,21,LAL,32,11,497,108,188,.574,0,0,,108,188,.574,.574,57,66,.864,53,105,158,24,4,27,31,71,273
